1c1
< #!DICT-ID pl.sgjp.sgjp-2018.10.14
---
> #!DICT-ID pl.sgjp.sgjp-2018.10.21
32904a32905,32927
> aleksandrowianach	aleksandrowianin	subst:pl:loc:m1	nazwa pospolita	
> aleksandrowian	aleksandrowianin	subst:pl:gen.acc:m1	nazwa pospolita	
> aleksandrowianami	aleksandrowianin	subst:pl:inst:m1	nazwa pospolita	
> aleksandrowianie	aleksandrowianin	subst:pl:nom.voc:m1	nazwa pospolita	
> aleksandrowianina	aleksandrowianin	subst:sg:gen.acc:m1	nazwa pospolita	
> aleksandrowianin	aleksandrowianin	subst:sg:nom:m1	nazwa pospolita	
> aleksandrowianinem	aleksandrowianin	subst:sg:inst:m1	nazwa pospolita	
> aleksandrowianinie	aleksandrowianin	subst:sg:loc:m1	nazwa pospolita	
> aleksandrowianinie	aleksandrowianin	subst:sg:voc:m1	nazwa pospolita	
> aleksandrowianinowi	aleksandrowianin	subst:sg:dat:m1	nazwa pospolita	
> aleksandrowianom	aleksandrowianin	subst:pl:dat:m1	nazwa pospolita	
> aleksandrowiany	aleksandrowianin	depr:pl:nom.acc.voc:m2	nazwa pospolita	
> aleksandrowiance	aleksandrowianka	subst:sg:dat.loc:f	nazwa pospolita	
> aleksandrowianek	aleksandrowianka	subst:pl:gen:f	nazwa pospolita	
> aleksandrowianka	aleksandrowianka	subst:sg:nom:f	nazwa pospolita	
> aleksandrowiankach	aleksandrowianka	subst:pl:loc:f	nazwa pospolita	
> aleksandrowiankami	aleksandrowianka	subst:pl:inst:f	nazwa pospolita	
> aleksandrowianką	aleksandrowianka	subst:sg:inst:f	nazwa pospolita	
> aleksandrowiankę	aleksandrowianka	subst:sg:acc:f	nazwa pospolita	
> aleksandrowianki	aleksandrowianka	subst:pl:nom.acc.voc:f	nazwa pospolita	
> aleksandrowianki	aleksandrowianka	subst:sg:gen:f	nazwa pospolita	
> aleksandrowianko	aleksandrowianka	subst:sg:voc:f	nazwa pospolita	
> aleksandrowiankom	aleksandrowianka	subst:pl:dat:f	nazwa pospolita	
145336a145360,145382
> barcelonce	barcelonka	subst:sg:dat.loc:f	nazwa pospolita	
> barcelonek	barcelonka	subst:pl:gen:f	nazwa pospolita	
> barcelonka	barcelonka	subst:sg:nom:f	nazwa pospolita	
> barcelonkach	barcelonka	subst:pl:loc:f	nazwa pospolita	
> barcelonkami	barcelonka	subst:pl:inst:f	nazwa pospolita	
> barcelonką	barcelonka	subst:sg:inst:f	nazwa pospolita	
> barcelonkę	barcelonka	subst:sg:acc:f	nazwa pospolita	
> barcelonki	barcelonka	subst:pl:nom.acc.voc:f	nazwa pospolita	
> barcelonki	barcelonka	subst:sg:gen:f	nazwa pospolita	
> barcelonko	barcelonka	subst:sg:voc:f	nazwa pospolita	
> barcelonkom	barcelonka	subst:pl:dat:f	nazwa pospolita	
> barcelończycy	barcelończyk	subst:pl:nom.voc:m1	nazwa pospolita	
> barcelończyka	barcelończyk	subst:sg:gen.acc:m1	nazwa pospolita	
> barcelończykach	barcelończyk	subst:pl:loc:m1	nazwa pospolita	
> barcelończykami	barcelończyk	subst:pl:inst:m1	nazwa pospolita	
> barcelończyk	barcelończyk	subst:sg:nom:m1	nazwa pospolita	
> barcelończyki	barcelończyk	depr:pl:nom.acc.voc:m2	nazwa pospolita	
> barcelończykiem	barcelończyk	subst:sg:inst:m1	nazwa pospolita	
> barcelończykom	barcelończyk	subst:pl:dat:m1	nazwa pospolita	
> barcelończykowi	barcelończyk	subst:sg:dat:m1	nazwa pospolita	
> barcelończyków	barcelończyk	subst:pl:gen.acc:m1	nazwa pospolita	
> barcelończyku	barcelończyk	subst:sg:loc:m1	nazwa pospolita	
> barcelończyku	barcelończyk	subst:sg:voc:m1	nazwa pospolita	
198539a198586,198597
> będzinianach	będzinianin	subst:pl:loc:m1	nazwa pospolita	
> będzinianami	będzinianin	subst:pl:inst:m1	nazwa pospolita	
> będzinian	będzinianin	subst:pl:gen.acc:m1	nazwa pospolita	
> będzinianie	będzinianin	subst:pl:nom.voc:m1	nazwa pospolita	
> będzinianina	będzinianin	subst:sg:gen.acc:m1	nazwa pospolita	
> będzinianin	będzinianin	subst:sg:nom:m1	nazwa pospolita	
> będzinianinem	będzinianin	subst:sg:inst:m1	nazwa pospolita	
> będzinianinie	będzinianin	subst:sg:loc:m1	nazwa pospolita	
> będzinianinie	będzinianin	subst:sg:voc:m1	nazwa pospolita	
> będzinianinowi	będzinianin	subst:sg:dat:m1	nazwa pospolita	
> będzinianom	będzinianin	subst:pl:dat:m1	nazwa pospolita	
> będziniany	będzinianin	depr:pl:nom.acc.voc:m2	nazwa pospolita	
202775a202834,202844
> białostoczance	białostoczanka	subst:sg:dat.loc:f	nazwa pospolita	
> białostoczanek	białostoczanka	subst:pl:gen:f	nazwa pospolita	
> białostoczanka	białostoczanka	subst:sg:nom:f	nazwa pospolita	
> białostoczankach	białostoczanka	subst:pl:loc:f	nazwa pospolita	
> białostoczankami	białostoczanka	subst:pl:inst:f	nazwa pospolita	
> białostoczanką	białostoczanka	subst:sg:inst:f	nazwa pospolita	
> białostoczankę	białostoczanka	subst:sg:acc:f	nazwa pospolita	
> białostoczanki	białostoczanka	subst:pl:nom.acc.voc:f	nazwa pospolita	
> białostoczanki	białostoczanka	subst:sg:gen:f	nazwa pospolita	
> białostoczanko	białostoczanka	subst:sg:voc:f	nazwa pospolita	
> białostoczankom	białostoczanka	subst:pl:dat:f	nazwa pospolita	
246035a246105,246127
> bochnianach	bochnianin	subst:pl:loc:m1	nazwa pospolita	
> bochnianami	bochnianin	subst:pl:inst:m1	nazwa pospolita	
> bochnian	bochnianin	subst:pl:gen.acc:m1	nazwa pospolita	
> bochnianie	bochnianin	subst:pl:nom.voc:m1	nazwa pospolita	
> bochnianina	bochnianin	subst:sg:gen.acc:m1	nazwa pospolita	
> bochnianin	bochnianin	subst:sg:nom:m1	nazwa pospolita	
> bochnianinem	bochnianin	subst:sg:inst:m1	nazwa pospolita	
> bochnianinie	bochnianin	subst:sg:loc:m1	nazwa pospolita	
> bochnianinie	bochnianin	subst:sg:voc:m1	nazwa pospolita	
> bochnianinowi	bochnianin	subst:sg:dat:m1	nazwa pospolita	
> bochnianom	bochnianin	subst:pl:dat:m1	nazwa pospolita	
> bochniany	bochnianin	depr:pl:nom.acc.voc:m2	nazwa pospolita	
> bochniance	bochnianka	subst:sg:dat.loc:f	nazwa pospolita	
> bochnianek	bochnianka	subst:pl:gen:f	nazwa pospolita	
> bochnianka	bochnianka	subst:sg:nom:f	nazwa pospolita	
> bochniankach	bochnianka	subst:pl:loc:f	nazwa pospolita	
> bochniankami	bochnianka	subst:pl:inst:f	nazwa pospolita	
> bochnianką	bochnianka	subst:sg:inst:f	nazwa pospolita	
> bochniankę	bochnianka	subst:sg:acc:f	nazwa pospolita	
> bochnianki	bochnianka	subst:pl:nom.acc.voc:f	nazwa pospolita	
> bochnianki	bochnianka	subst:sg:gen:f	nazwa pospolita	
> bochnianko	bochnianka	subst:sg:voc:f	nazwa pospolita	
> bochniankom	bochnianka	subst:pl:dat:f	nazwa pospolita	
291753a291846,291857
> Brytola	Brytol	subst:sg:gen.acc:m1	nazwa pospolita	pot.
> Brytolach	Brytol	subst:pl:loc:m1	nazwa pospolita	pot.
> Brytolami	Brytol	subst:pl:inst:m1	nazwa pospolita	pot.
> Brytol	Brytol	subst:sg:nom:m1	nazwa pospolita	pot.
> Brytole	Brytol	depr:pl:nom.acc.voc:m2	nazwa pospolita	pot.
> Brytole	Brytol	subst:pl:nom.voc:m1	nazwa pospolita	pot.
> Brytolem	Brytol	subst:sg:inst:m1	nazwa pospolita	pot.
> Brytolom	Brytol	subst:pl:dat:m1	nazwa pospolita	pot.
> Brytolowi	Brytol	subst:sg:dat:m1	nazwa pospolita	pot.
> Brytolów	Brytol	subst:pl:gen.acc:m1	nazwa pospolita	pot.
> Brytolu	Brytol	subst:sg:loc:m1	nazwa pospolita	pot.
> Brytolu	Brytol	subst:sg:voc:m1	nazwa pospolita	pot.
321479a321584,321606
> busczanach	busczanin	subst:pl:loc:m1	nazwa pospolita	
> busczanami	busczanin	subst:pl:inst:m1	nazwa pospolita	
> busczan	busczanin	subst:pl:gen.acc:m1	nazwa pospolita	
> busczanie	busczanin	subst:pl:nom.voc:m1	nazwa pospolita	
> busczanina	busczanin	subst:sg:gen.acc:m1	nazwa pospolita	
> busczanin	busczanin	subst:sg:nom:m1	nazwa pospolita	
> busczaninem	busczanin	subst:sg:inst:m1	nazwa pospolita	
> busczaninie	busczanin	subst:sg:loc:m1	nazwa pospolita	
> busczaninie	busczanin	subst:sg:voc:m1	nazwa pospolita	
> busczaninowi	busczanin	subst:sg:dat:m1	nazwa pospolita	
> busczanom	busczanin	subst:pl:dat:m1	nazwa pospolita	
> busczany	busczanin	depr:pl:nom.acc.voc:m2	nazwa pospolita	
> busczance	busczanka	subst:sg:dat.loc:f	nazwa pospolita	
> busczanek	busczanka	subst:pl:gen:f	nazwa pospolita	
> busczanka	busczanka	subst:sg:nom:f	nazwa pospolita	
> busczankach	busczanka	subst:pl:loc:f	nazwa pospolita	
> busczankami	busczanka	subst:pl:inst:f	nazwa pospolita	
> busczanką	busczanka	subst:sg:inst:f	nazwa pospolita	
> busczankę	busczanka	subst:sg:acc:f	nazwa pospolita	
> busczanki	busczanka	subst:pl:nom.acc.voc:f	nazwa pospolita	
> busczanki	busczanka	subst:sg:gen:f	nazwa pospolita	
> busczanko	busczanka	subst:sg:voc:f	nazwa pospolita	
> busczankom	busczanka	subst:pl:dat:f	nazwa pospolita	
321760a321888,321910
> buskowianach	buskowianin	subst:pl:loc:m1	nazwa pospolita	
> buskowianami	buskowianin	subst:pl:inst:m1	nazwa pospolita	
> buskowian	buskowianin	subst:pl:gen.acc:m1	nazwa pospolita	
> buskowianie	buskowianin	subst:pl:nom.voc:m1	nazwa pospolita	
> buskowianina	buskowianin	subst:sg:gen.acc:m1	nazwa pospolita	
> buskowianin	buskowianin	subst:sg:nom:m1	nazwa pospolita	
> buskowianinem	buskowianin	subst:sg:inst:m1	nazwa pospolita	
> buskowianinie	buskowianin	subst:sg:loc:m1	nazwa pospolita	
> buskowianinie	buskowianin	subst:sg:voc:m1	nazwa pospolita	
> buskowianinowi	buskowianin	subst:sg:dat:m1	nazwa pospolita	
> buskowianom	buskowianin	subst:pl:dat:m1	nazwa pospolita	
> buskowiany	buskowianin	depr:pl:nom.acc.voc:m2	nazwa pospolita	
> buskowiance	buskowianka	subst:sg:dat.loc:f	nazwa pospolita	
> buskowianek	buskowianka	subst:pl:gen:f	nazwa pospolita	
> buskowianka	buskowianka	subst:sg:nom:f	nazwa pospolita	
> buskowiankach	buskowianka	subst:pl:loc:f	nazwa pospolita	
> buskowiankami	buskowianka	subst:pl:inst:f	nazwa pospolita	
> buskowianką	buskowianka	subst:sg:inst:f	nazwa pospolita	
> buskowiankę	buskowianka	subst:sg:acc:f	nazwa pospolita	
> buskowianki	buskowianka	subst:pl:nom.acc.voc:f	nazwa pospolita	
> buskowianki	buskowianka	subst:sg:gen:f	nazwa pospolita	
> buskowianko	buskowianka	subst:sg:voc:f	nazwa pospolita	
> buskowiankom	buskowianka	subst:pl:dat:f	nazwa pospolita	
322000a322151,322173
> buszczanach	buszczanin	subst:pl:loc:m1	nazwa pospolita	
> buszczanami	buszczanin	subst:pl:inst:m1	nazwa pospolita	
> buszczan	buszczanin	subst:pl:gen.acc:m1	nazwa pospolita	
> buszczanie	buszczanin	subst:pl:nom.voc:m1	nazwa pospolita	
> buszczanina	buszczanin	subst:sg:gen.acc:m1	nazwa pospolita	
> buszczanin	buszczanin	subst:sg:nom:m1	nazwa pospolita	
> buszczaninem	buszczanin	subst:sg:inst:m1	nazwa pospolita	
> buszczaninie	buszczanin	subst:sg:loc:m1	nazwa pospolita	
> buszczaninie	buszczanin	subst:sg:voc:m1	nazwa pospolita	
> buszczaninowi	buszczanin	subst:sg:dat:m1	nazwa pospolita	
> buszczanom	buszczanin	subst:pl:dat:m1	nazwa pospolita	
> buszczany	buszczanin	depr:pl:nom.acc.voc:m2	nazwa pospolita	
> buszczance	buszczanka	subst:sg:dat.loc:f	nazwa pospolita	
> buszczanek	buszczanka	subst:pl:gen:f	nazwa pospolita	
> buszczanka	buszczanka	subst:sg:nom:f	nazwa pospolita	
> buszczankach	buszczanka	subst:pl:loc:f	nazwa pospolita	
> buszczankami	buszczanka	subst:pl:inst:f	nazwa pospolita	
> buszczanką	buszczanka	subst:sg:inst:f	nazwa pospolita	
> buszczankę	buszczanka	subst:sg:acc:f	nazwa pospolita	
> buszczanki	buszczanka	subst:pl:nom.acc.voc:f	nazwa pospolita	
> buszczanki	buszczanka	subst:sg:gen:f	nazwa pospolita	
> buszczanko	buszczanka	subst:sg:voc:f	nazwa pospolita	
> buszczankom	buszczanka	subst:pl:dat:f	nazwa pospolita	
365290a365464,365475
> Chinolach	Chinol	subst:pl:loc:m1	nazwa pospolita	pot.
> Chinola	Chinol	subst:sg:gen.acc:m1	nazwa pospolita	pot.
> Chinolami	Chinol	subst:pl:inst:m1	nazwa pospolita	pot.
> Chinol	Chinol	subst:sg:nom:m1	nazwa pospolita	pot.
> Chinole	Chinol	depr:pl:nom.acc.voc:m2	nazwa pospolita	pot.
> Chinole	Chinol	subst:pl:nom.voc:m1	nazwa pospolita	pot.
> Chinolem	Chinol	subst:sg:inst:m1	nazwa pospolita	pot.
> Chinolom	Chinol	subst:pl:dat:m1	nazwa pospolita	pot.
> Chinolowi	Chinol	subst:sg:dat:m1	nazwa pospolita	pot.
> Chinolów	Chinol	subst:pl:gen.acc:m1	nazwa pospolita	pot.
> Chinolu	Chinol	subst:sg:loc:m1	nazwa pospolita	pot.
> Chinolu	Chinol	subst:sg:voc:m1	nazwa pospolita	pot.
378852a379038,379071
> Chodzieżach	Chodzież	subst:pl:loc:f	nazwa geograficzna	
> Chodzieżami	Chodzież	subst:pl:inst:f	nazwa geograficzna	
> Chodzieżą	Chodzież	subst:sg:inst:f	nazwa geograficzna	
> Chodzież	Chodzież	subst:sg:acc:f	nazwa geograficzna	
> Chodzież	Chodzież	subst:sg:nom:f	nazwa geograficzna	
> Chodzieże	Chodzież	subst:pl:nom.acc.voc:f	nazwa geograficzna	
> Chodzieżom	Chodzież	subst:pl:dat:f	nazwa geograficzna	
> Chodzieży	Chodzież	subst:pl:gen:f	nazwa geograficzna	
> Chodzieży	Chodzież	subst:sg:dat.loc:f	nazwa geograficzna	
> Chodzieży	Chodzież	subst:sg:gen:f	nazwa geograficzna	
> Chodzieży	Chodzież	subst:sg:voc:f	nazwa geograficzna	
> chodzieżanach	chodzieżanin	subst:pl:loc:m1	nazwa pospolita	
> chodzieżanami	chodzieżanin	subst:pl:inst:m1	nazwa pospolita	
> chodzieżan	chodzieżanin	subst:pl:gen.acc:m1	nazwa pospolita	
> chodzieżanie	chodzieżanin	subst:pl:nom.voc:m1	nazwa pospolita	
> chodzieżanina	chodzieżanin	subst:sg:gen.acc:m1	nazwa pospolita	
> chodzieżanin	chodzieżanin	subst:sg:nom:m1	nazwa pospolita	
> chodzieżaninem	chodzieżanin	subst:sg:inst:m1	nazwa pospolita	
> chodzieżaninie	chodzieżanin	subst:sg:loc:m1	nazwa pospolita	
> chodzieżaninie	chodzieżanin	subst:sg:voc:m1	nazwa pospolita	
> chodzieżaninowi	chodzieżanin	subst:sg:dat:m1	nazwa pospolita	
> chodzieżanom	chodzieżanin	subst:pl:dat:m1	nazwa pospolita	
> chodzieżany	chodzieżanin	depr:pl:nom.acc.voc:m2	nazwa pospolita	
> chodzieżance	chodzieżanka	subst:sg:dat.loc:f	nazwa pospolita	
> chodzieżanek	chodzieżanka	subst:pl:gen:f	nazwa pospolita	
> chodzieżankach	chodzieżanka	subst:pl:loc:f	nazwa pospolita	
> chodzieżanka	chodzieżanka	subst:sg:nom:f	nazwa pospolita	
> chodzieżankami	chodzieżanka	subst:pl:inst:f	nazwa pospolita	
> chodzieżanką	chodzieżanka	subst:sg:inst:f	nazwa pospolita	
> chodzieżankę	chodzieżanka	subst:sg:acc:f	nazwa pospolita	
> chodzieżanki	chodzieżanka	subst:pl:nom.acc.voc:f	nazwa pospolita	
> chodzieżanki	chodzieżanka	subst:sg:gen:f	nazwa pospolita	
> chodzieżanko	chodzieżanka	subst:sg:voc:f	nazwa pospolita	
> chodzieżankom	chodzieżanka	subst:pl:dat:f	nazwa pospolita	
384764a384984,385016
> choszcznianach	choszcznianin	subst:pl:loc:m1	nazwa pospolita	
> choszcznianami	choszcznianin	subst:pl:inst:m1	nazwa pospolita	
> choszcznian	choszcznianin	subst:pl:gen.acc:m1	nazwa pospolita	
> choszcznianie	choszcznianin	subst:pl:nom.voc:m1	nazwa pospolita	
> choszcznianina	choszcznianin	subst:sg:gen.acc:m1	nazwa pospolita	
> choszcznianin	choszcznianin	subst:sg:nom:m1	nazwa pospolita	
> choszcznianinem	choszcznianin	subst:sg:inst:m1	nazwa pospolita	
> choszcznianinie	choszcznianin	subst:sg:loc:m1	nazwa pospolita	
> choszcznianinie	choszcznianin	subst:sg:voc:m1	nazwa pospolita	
> choszcznianinowi	choszcznianin	subst:sg:dat:m1	nazwa pospolita	
> choszcznianom	choszcznianin	subst:pl:dat:m1	nazwa pospolita	
> choszczniany	choszcznianin	depr:pl:nom.acc.voc:m2	nazwa pospolita	
> choszczniance	choszcznianka	subst:sg:dat.loc:f	nazwa pospolita	
> choszcznianek	choszcznianka	subst:pl:gen:f	nazwa pospolita	
> choszczniankach	choszcznianka	subst:pl:loc:f	nazwa pospolita	
> choszcznianka	choszcznianka	subst:sg:nom:f	nazwa pospolita	
> choszczniankami	choszcznianka	subst:pl:inst:f	nazwa pospolita	
> choszcznianką	choszcznianka	subst:sg:inst:f	nazwa pospolita	
> choszczniankę	choszcznianka	subst:sg:acc:f	nazwa pospolita	
> choszcznianki	choszcznianka	subst:pl:nom.acc.voc:f	nazwa pospolita	
> choszcznianki	choszcznianka	subst:sg:gen:f	nazwa pospolita	
> choszcznianko	choszcznianka	subst:sg:voc:f	nazwa pospolita	
> choszczniankom	choszcznianka	subst:pl:dat:f	nazwa pospolita	
> Choszcznach	Choszczno	subst:pl:loc:n:ncol	nazwa geograficzna	
> Choszczna	Choszczno	subst:pl:nom.acc.voc:n:ncol	nazwa geograficzna	
> Choszczna	Choszczno	subst:sg:gen:n:ncol	nazwa geograficzna	
> Choszcznami	Choszczno	subst:pl:inst:n:ncol	nazwa geograficzna	
> Choszczn	Choszczno	subst:pl:gen:n:ncol	nazwa geograficzna	
> Choszcznem	Choszczno	subst:sg:inst:n:ncol	nazwa geograficzna	
> Choszcznie	Choszczno	subst:sg:loc:n:ncol	nazwa geograficzna	
> Choszczno	Choszczno	subst:sg:nom.acc.voc:n:ncol	nazwa geograficzna	
> Choszcznom	Choszczno	subst:pl:dat:n:ncol	nazwa geograficzna	
> Choszcznu	Choszczno	subst:sg:dat:n:ncol	nazwa geograficzna	
553980a554233,554255
> dębiczanach	dębiczanin	subst:pl:loc:m1	nazwa pospolita	
> dębiczanami	dębiczanin	subst:pl:inst:m1	nazwa pospolita	
> dębiczan	dębiczanin	subst:pl:gen.acc:m1	nazwa pospolita	
> dębiczanie	dębiczanin	subst:pl:nom.voc:m1	nazwa pospolita	
> dębiczanina	dębiczanin	subst:sg:gen.acc:m1	nazwa pospolita	
> dębiczanin	dębiczanin	subst:sg:nom:m1	nazwa pospolita	
> dębiczaninem	dębiczanin	subst:sg:inst:m1	nazwa pospolita	
> dębiczaninie	dębiczanin	subst:sg:loc:m1	nazwa pospolita	
> dębiczaninie	dębiczanin	subst:sg:voc:m1	nazwa pospolita	
> dębiczaninowi	dębiczanin	subst:sg:dat:m1	nazwa pospolita	
> dębiczanom	dębiczanin	subst:pl:dat:m1	nazwa pospolita	
> dębiczany	dębiczanin	depr:pl:nom.acc.voc:m2	nazwa pospolita	
> dębiczance	dębiczanka	subst:sg:dat.loc:f	nazwa pospolita	
> dębiczanek	dębiczanka	subst:pl:gen:f	nazwa pospolita	
> dębiczankach	dębiczanka	subst:pl:loc:f	nazwa pospolita	
> dębiczanka	dębiczanka	subst:sg:nom:f	nazwa pospolita	
> dębiczankami	dębiczanka	subst:pl:inst:f	nazwa pospolita	
> dębiczanką	dębiczanka	subst:sg:inst:f	nazwa pospolita	
> dębiczankę	dębiczanka	subst:sg:acc:f	nazwa pospolita	
> dębiczanki	dębiczanka	subst:pl:nom.acc.voc:f	nazwa pospolita	
> dębiczanki	dębiczanka	subst:sg:gen:f	nazwa pospolita	
> dębiczanko	dębiczanka	subst:sg:voc:f	nazwa pospolita	
> dębiczankom	dębiczanka	subst:pl:dat:f	nazwa pospolita	
894782a895058,895068
> frankfurtce	frankfurtka	subst:sg:dat.loc:f	nazwa pospolita	
> frankfurtek	frankfurtka	subst:pl:gen:f	nazwa pospolita	
> frankfurtkach	frankfurtka	subst:pl:loc:f	nazwa pospolita	
> frankfurtka	frankfurtka	subst:sg:nom:f	nazwa pospolita	
> frankfurtkami	frankfurtka	subst:pl:inst:f	nazwa pospolita	
> frankfurtką	frankfurtka	subst:sg:inst:f	nazwa pospolita	
> frankfurtkę	frankfurtka	subst:sg:acc:f	nazwa pospolita	
> frankfurtki	frankfurtka	subst:pl:nom.acc.voc:f	nazwa pospolita	
> frankfurtki	frankfurtka	subst:sg:gen:f	nazwa pospolita	
> frankfurtko	frankfurtka	subst:sg:voc:f	nazwa pospolita	
> frankfurtkom	frankfurtka	subst:pl:dat:f	nazwa pospolita	
921342a921629,921639
> Galicjance	Galicjanka	subst:sg:dat.loc:f	nazwa pospolita	
> Galicjanek	Galicjanka	subst:pl:gen:f	nazwa pospolita	
> Galicjankach	Galicjanka	subst:pl:loc:f	nazwa pospolita	
> Galicjanka	Galicjanka	subst:sg:nom:f	nazwa pospolita	
> Galicjankami	Galicjanka	subst:pl:inst:f	nazwa pospolita	
> Galicjanką	Galicjanka	subst:sg:inst:f	nazwa pospolita	
> Galicjankę	Galicjanka	subst:sg:acc:f	nazwa pospolita	
> Galicjanki	Galicjanka	subst:pl:nom.acc.voc:f	nazwa pospolita	
> Galicjanki	Galicjanka	subst:sg:gen:f	nazwa pospolita	
> Galicjanko	Galicjanka	subst:sg:voc:f	nazwa pospolita	
> Galicjankom	Galicjanka	subst:pl:dat:f	nazwa pospolita	
935758a936056,936066
> Garwolinach	Garwolin	subst:pl:loc:m3	nazwa geograficzna	
> Garwolina	Garwolin	subst:sg:gen:m3	nazwa geograficzna	
> Garwolinami	Garwolin	subst:pl:inst:m3	nazwa geograficzna	
> Garwolinem	Garwolin	subst:sg:inst:m3	nazwa geograficzna	
> Garwolin	Garwolin	subst:sg:nom.acc:m3	nazwa geograficzna	
> Garwolinie	Garwolin	subst:sg:loc:m3	nazwa geograficzna	
> Garwolinie	Garwolin	subst:sg:voc:m3	nazwa geograficzna	
> Garwolinom	Garwolin	subst:pl:dat:m3	nazwa geograficzna	
> Garwolinowi	Garwolin	subst:sg:dat:m3	nazwa geograficzna	
> Garwolinów	Garwolin	subst:pl:gen:m3	nazwa geograficzna	
> Garwoliny	Garwolin	subst:pl:nom.acc.voc:m3	nazwa geograficzna	
1008007a1008316,1008326
> Gostyninach	Gostynin	subst:pl:loc:m3	nazwa geograficzna	
> Gostynina	Gostynin	subst:sg:gen:m3	nazwa geograficzna	
> Gostyninami	Gostynin	subst:pl:inst:m3	nazwa geograficzna	
> Gostyninem	Gostynin	subst:sg:inst:m3	nazwa geograficzna	
> Gostynin	Gostynin	subst:sg:nom.acc:m3	nazwa geograficzna	
> Gostyninie	Gostynin	subst:sg:loc:m3	nazwa geograficzna	
> Gostyninie	Gostynin	subst:sg:voc:m3	nazwa geograficzna	
> Gostyninom	Gostynin	subst:pl:dat:m3	nazwa geograficzna	
> Gostyninowi	Gostynin	subst:sg:dat:m3	nazwa geograficzna	
> Gostyninów	Gostynin	subst:pl:gen:m3	nazwa geograficzna	
> Gostyniny	Gostynin	subst:pl:nom.acc.voc:m3	nazwa geograficzna	
1044182a1044502,1044511
> Gryfinach	Gryfino	subst:pl:loc:n:ncol	nazwa geograficzna	
> Gryfina	Gryfino	subst:pl:nom.acc.voc:n:ncol	nazwa geograficzna	
> Gryfina	Gryfino	subst:sg:gen:n:ncol	nazwa geograficzna	
> Gryfinami	Gryfino	subst:pl:inst:n:ncol	nazwa geograficzna	
> Gryfinem	Gryfino	subst:sg:inst:n:ncol	nazwa geograficzna	
> Gryfin	Gryfino	subst:pl:gen:n:ncol	nazwa geograficzna	
> Gryfinie	Gryfino	subst:sg:loc:n:ncol	nazwa geograficzna	
> Gryfino	Gryfino	subst:sg:nom.acc.voc:n:ncol	nazwa geograficzna	
> Gryfinom	Gryfino	subst:pl:dat:n:ncol	nazwa geograficzna	
> Gryfinu	Gryfino	subst:sg:dat:n:ncol	nazwa geograficzna	
1125001a1125331,1125353
> Hongkonce	Hongkonka	subst:sg:dat.loc:f	nazwa pospolita	
> Hongkonek	Hongkonka	subst:pl:gen:f	nazwa pospolita	
> Hongkonkach	Hongkonka	subst:pl:loc:f	nazwa pospolita	
> Hongkonka	Hongkonka	subst:sg:nom:f	nazwa pospolita	
> Hongkonkami	Hongkonka	subst:pl:inst:f	nazwa pospolita	
> Hongkonką	Hongkonka	subst:sg:inst:f	nazwa pospolita	
> Hongkonkę	Hongkonka	subst:sg:acc:f	nazwa pospolita	
> Hongkonki	Hongkonka	subst:pl:nom.acc.voc:f	nazwa pospolita	
> Hongkonki	Hongkonka	subst:sg:gen:f	nazwa pospolita	
> Hongkonko	Hongkonka	subst:sg:voc:f	nazwa pospolita	
> Hongkonkom	Hongkonka	subst:pl:dat:f	nazwa pospolita	
> Hongkończycy	Hongkończyk	subst:pl:nom.voc:m1	nazwa pospolita	
> Hongkończykach	Hongkończyk	subst:pl:loc:m1	nazwa pospolita	
> Hongkończyka	Hongkończyk	subst:sg:gen.acc:m1	nazwa pospolita	
> Hongkończykami	Hongkończyk	subst:pl:inst:m1	nazwa pospolita	
> Hongkończyk	Hongkończyk	subst:sg:nom:m1	nazwa pospolita	
> Hongkończykiem	Hongkończyk	subst:sg:inst:m1	nazwa pospolita	
> Hongkończyki	Hongkończyk	depr:pl:nom.acc.voc:m2	nazwa pospolita	
> Hongkończykom	Hongkończyk	subst:pl:dat:m1	nazwa pospolita	
> Hongkończykowi	Hongkończyk	subst:sg:dat:m1	nazwa pospolita	
> Hongkończyków	Hongkończyk	subst:pl:gen.acc:m1	nazwa pospolita	
> Hongkończyku	Hongkończyk	subst:sg:loc:m1	nazwa pospolita	
> Hongkończyku	Hongkończyk	subst:sg:voc:m1	nazwa pospolita	
1210260a1210613,1210635
> janowianach	janowianin	subst:pl:loc:m1	nazwa pospolita	
> janowianami	janowianin	subst:pl:inst:m1	nazwa pospolita	
> janowianie	janowianin	subst:pl:nom.voc:m1	nazwa pospolita	
> janowianina	janowianin	subst:sg:gen.acc:m1	nazwa pospolita	
> janowianinem	janowianin	subst:sg:inst:m1	nazwa pospolita	
> janowianinie	janowianin	subst:sg:loc:m1	nazwa pospolita	
> janowianinie	janowianin	subst:sg:voc:m1	nazwa pospolita	
> janowianin	janowianin	subst:sg:nom:m1	nazwa pospolita	
> janowianinowi	janowianin	subst:sg:dat:m1	nazwa pospolita	
> janowian	janowianin	subst:pl:gen.acc:m1	nazwa pospolita	
> janowianom	janowianin	subst:pl:dat:m1	nazwa pospolita	
> janowiany	janowianin	depr:pl:nom.acc.voc:m2	nazwa pospolita	
> janowiance	janowianka	subst:sg:dat.loc:f	nazwa pospolita	
> janowianek	janowianka	subst:pl:gen:f	nazwa pospolita	
> janowiankach	janowianka	subst:pl:loc:f	nazwa pospolita	
> janowianka	janowianka	subst:sg:nom:f	nazwa pospolita	
> janowiankami	janowianka	subst:pl:inst:f	nazwa pospolita	
> janowianką	janowianka	subst:sg:inst:f	nazwa pospolita	
> janowiankę	janowianka	subst:sg:acc:f	nazwa pospolita	
> janowianki	janowianka	subst:pl:nom.acc.voc:f	nazwa pospolita	
> janowianki	janowianka	subst:sg:gen:f	nazwa pospolita	
> janowianko	janowianka	subst:sg:voc:f	nazwa pospolita	
> janowiankom	janowianka	subst:pl:dat:f	nazwa pospolita	
1211590a1211966,1211977
> Japoniec	Japoniec	subst:sg:nom:m1	nazwa pospolita	pot.
> Japońcach	Japoniec	subst:pl:loc:m1	nazwa pospolita	pot.
> Japońca	Japoniec	subst:sg:gen.acc:m1	nazwa pospolita	pot.
> Japońcami	Japoniec	subst:pl:inst:m1	nazwa pospolita	pot.
> Japońce	Japoniec	depr:pl:nom.acc.voc:m2	nazwa pospolita	pot.
> Japońcem	Japoniec	subst:sg:inst:m1	nazwa pospolita	pot.
> Japońcom	Japoniec	subst:pl:dat:m1	nazwa pospolita	pot.
> Japońcowi	Japoniec	subst:sg:dat:m1	nazwa pospolita	pot.
> Japońców	Japoniec	subst:pl:gen.acc:m1	nazwa pospolita	pot.
> Japońcu	Japoniec	subst:sg:loc:m1	nazwa pospolita	pot.
> Japońcu	Japoniec	subst:sg:voc:m1	nazwa pospolita	pot.
> Japońcy	Japoniec	subst:pl:nom.voc:m1	nazwa pospolita	pot.
1222514a1222902,1222924
> jaślanach	jaślanin	subst:pl:loc:m1	nazwa pospolita	
> jaślanami	jaślanin	subst:pl:inst:m1	nazwa pospolita	
> jaślanie	jaślanin	subst:pl:nom.voc:m1	nazwa pospolita	
> jaślanina	jaślanin	subst:sg:gen.acc:m1	nazwa pospolita	
> jaślaninem	jaślanin	subst:sg:inst:m1	nazwa pospolita	
> jaślaninie	jaślanin	subst:sg:loc:m1	nazwa pospolita	
> jaślaninie	jaślanin	subst:sg:voc:m1	nazwa pospolita	
> jaślanin	jaślanin	subst:sg:nom:m1	nazwa pospolita	
> jaślaninowi	jaślanin	subst:sg:dat:m1	nazwa pospolita	
> jaślan	jaślanin	subst:pl:gen.acc:m1	nazwa pospolita	
> jaślanom	jaślanin	subst:pl:dat:m1	nazwa pospolita	
> jaślany	jaślanin	depr:pl:nom.acc.voc:m2	nazwa pospolita	
> jaślance	jaślanka	subst:sg:dat.loc:f	nazwa pospolita	
> jaślanek	jaślanka	subst:pl:gen:f	nazwa pospolita	
> jaślankach	jaślanka	subst:pl:loc:f	nazwa pospolita	
> jaślanka	jaślanka	subst:sg:nom:f	nazwa pospolita	
> jaślankami	jaślanka	subst:pl:inst:f	nazwa pospolita	
> jaślanką	jaślanka	subst:sg:inst:f	nazwa pospolita	
> jaślankę	jaślanka	subst:sg:acc:f	nazwa pospolita	
> jaślanki	jaślanka	subst:pl:nom.acc.voc:f	nazwa pospolita	
> jaślanki	jaślanka	subst:sg:gen:f	nazwa pospolita	
> jaślanko	jaślanka	subst:sg:voc:f	nazwa pospolita	
> jaślankom	jaślanka	subst:pl:dat:f	nazwa pospolita	
1224326a1224737,1224747
> Jaworach	Jawor:s1	subst:pl:loc:m3	nazwa geograficzna	
> Jaworami	Jawor:s1	subst:pl:inst:m3	nazwa geograficzna	
> Jaworem	Jawor:s1	subst:sg:inst:m3	nazwa geograficzna	
> Jawor	Jawor:s1	subst:sg:nom.acc:m3	nazwa geograficzna	
> Jaworom	Jawor:s1	subst:pl:dat:m3	nazwa geograficzna	
> Jaworowi	Jawor:s1	subst:sg:dat:m3	nazwa geograficzna	
> Jaworów	Jawor:s1	subst:pl:gen:m3	nazwa geograficzna	
> Jaworu	Jawor:s1	subst:sg:gen:m3	nazwa geograficzna	
> Jawory	Jawor:s1	subst:pl:nom.acc.voc:m3	nazwa geograficzna	
> Jaworze	Jawor:s1	subst:sg:loc:m3	nazwa geograficzna	
> Jaworze	Jawor:s1	subst:sg:voc:m3	nazwa geograficzna	
1224399a1224821,1224843
> jaworzanach	jaworzanin	subst:pl:loc:m1	nazwa pospolita	
> jaworzanami	jaworzanin	subst:pl:inst:m1	nazwa pospolita	
> jaworzanie	jaworzanin	subst:pl:nom.voc:m1	nazwa pospolita	
> jaworzanina	jaworzanin	subst:sg:gen.acc:m1	nazwa pospolita	
> jaworzaninem	jaworzanin	subst:sg:inst:m1	nazwa pospolita	
> jaworzaninie	jaworzanin	subst:sg:loc:m1	nazwa pospolita	
> jaworzaninie	jaworzanin	subst:sg:voc:m1	nazwa pospolita	
> jaworzanin	jaworzanin	subst:sg:nom:m1	nazwa pospolita	
> jaworzaninowi	jaworzanin	subst:sg:dat:m1	nazwa pospolita	
> jaworzan	jaworzanin	subst:pl:gen.acc:m1	nazwa pospolita	
> jaworzanom	jaworzanin	subst:pl:dat:m1	nazwa pospolita	
> jaworzany	jaworzanin	depr:pl:nom.acc.voc:m2	nazwa pospolita	
> jaworzance	jaworzanka	subst:sg:dat.loc:f	nazwa pospolita	
> jaworzanek	jaworzanka	subst:pl:gen:f	nazwa pospolita	
> jaworzankach	jaworzanka	subst:pl:loc:f	nazwa pospolita	
> jaworzanka	jaworzanka	subst:sg:nom:f	nazwa pospolita	
> jaworzankami	jaworzanka	subst:pl:inst:f	nazwa pospolita	
> jaworzanką	jaworzanka	subst:sg:inst:f	nazwa pospolita	
> jaworzankę	jaworzanka	subst:sg:acc:f	nazwa pospolita	
> jaworzanki	jaworzanka	subst:pl:nom.acc.voc:f	nazwa pospolita	
> jaworzanki	jaworzanka	subst:sg:gen:f	nazwa pospolita	
> jaworzanko	jaworzanka	subst:sg:voc:f	nazwa pospolita	
> jaworzankom	jaworzanka	subst:pl:dat:f	nazwa pospolita	
1224436a1224881,1224890
> Jaworzach	Jaworze	subst:pl:loc:n:ncol	nazwa geograficzna	
> Jaworza	Jaworze	subst:pl:nom.acc.voc:n:ncol	nazwa geograficzna	
> Jaworza	Jaworze	subst:sg:gen:n:ncol	nazwa geograficzna	
> Jaworzami	Jaworze	subst:pl:inst:n:ncol	nazwa geograficzna	
> Jaworze	Jaworze	subst:sg:nom.acc.voc:n:ncol	nazwa geograficzna	
> Jaworzem	Jaworze	subst:sg:inst:n:ncol	nazwa geograficzna	
> Jaworzom	Jaworze	subst:pl:dat:n:ncol	nazwa geograficzna	
> Jaworzu	Jaworze	subst:sg:dat:n:ncol	nazwa geograficzna	
> Jaworzu	Jaworze	subst:sg:loc:n:ncol	nazwa geograficzna	
> Jaworzy	Jaworze	subst:pl:gen:n:ncol	nazwa geograficzna	
1319542a1319997,1320006
> Kartuzach	Kartuzy	subst:pl:loc:n:pt	nazwa geograficzna	
> Kartuzach	Kartuzy	subst:pl:loc:n:pt	nazwa geograficzna	
> Kartuzami	Kartuzy	subst:pl:inst:n:pt	nazwa geograficzna	
> Kartuzami	Kartuzy	subst:pl:inst:n:pt	nazwa geograficzna	
> Kartuzom	Kartuzy	subst:pl:dat:n:pt	nazwa geograficzna	
> Kartuzom	Kartuzy	subst:pl:dat:n:pt	nazwa geograficzna	
> Kartuzów	Kartuzy	subst:pl:gen:n:pt	nazwa geograficzna	
> Kartuzów	Kartuzy	subst:pl:gen:n:pt	nazwa geograficzna	
> Kartuzy	Kartuzy	subst:pl:nom.acc.voc:n:pt	nazwa geograficzna	
> Kartuzy	Kartuzy	subst:pl:nom.acc.voc:n:pt	nazwa geograficzna	
1345083a1345548,1345580
> kępnianach	kępnianin	subst:pl:loc:m1	nazwa pospolita	
> kępnianami	kępnianin	subst:pl:inst:m1	nazwa pospolita	
> kępnianie	kępnianin	subst:pl:nom.voc:m1	nazwa pospolita	
> kępnianina	kępnianin	subst:sg:gen.acc:m1	nazwa pospolita	
> kępnianinem	kępnianin	subst:sg:inst:m1	nazwa pospolita	
> kępnianinie	kępnianin	subst:sg:loc:m1	nazwa pospolita	
> kępnianinie	kępnianin	subst:sg:voc:m1	nazwa pospolita	
> kępnianin	kępnianin	subst:sg:nom:m1	nazwa pospolita	
> kępnianinowi	kępnianin	subst:sg:dat:m1	nazwa pospolita	
> kępnian	kępnianin	subst:pl:gen.acc:m1	nazwa pospolita	
> kępnianom	kępnianin	subst:pl:dat:m1	nazwa pospolita	
> kępniany	kępnianin	depr:pl:nom.acc.voc:m2	nazwa pospolita	
> kępniance	kępnianka	subst:sg:dat.loc:f	nazwa pospolita	
> kępnianek	kępnianka	subst:pl:gen:f	nazwa pospolita	
> kępniankach	kępnianka	subst:pl:loc:f	nazwa pospolita	
> kępnianka	kępnianka	subst:sg:nom:f	nazwa pospolita	
> kępniankami	kępnianka	subst:pl:inst:f	nazwa pospolita	
> kępnianką	kępnianka	subst:sg:inst:f	nazwa pospolita	
> kępniankę	kępnianka	subst:sg:acc:f	nazwa pospolita	
> kępnianki	kępnianka	subst:pl:nom.acc.voc:f	nazwa pospolita	
> kępnianki	kępnianka	subst:sg:gen:f	nazwa pospolita	
> kępnianko	kępnianka	subst:sg:voc:f	nazwa pospolita	
> kępniankom	kępnianka	subst:pl:dat:f	nazwa pospolita	
> Kępnach	Kępno	subst:pl:loc:n:ncol	nazwa geograficzna	
> Kępna	Kępno	subst:pl:nom.acc.voc:n:ncol	nazwa geograficzna	
> Kępna	Kępno	subst:sg:gen:n:ncol	nazwa geograficzna	
> Kępnami	Kępno	subst:pl:inst:n:ncol	nazwa geograficzna	
> Kępnem	Kępno	subst:sg:inst:n:ncol	nazwa geograficzna	
> Kępnie	Kępno	subst:sg:loc:n:ncol	nazwa geograficzna	
> Kępn	Kępno	subst:pl:gen:n:ncol	nazwa geograficzna	
> Kępno	Kępno	subst:sg:nom.acc.voc:n:ncol	nazwa geograficzna	
> Kępnom	Kępno	subst:pl:dat:n:ncol	nazwa geograficzna	
> Kępnu	Kępno	subst:sg:dat:n:ncol	nazwa geograficzna	
1423109a1423607,1423639
> kolnianach	kolnianin	subst:pl:loc:m1	nazwa pospolita	
> kolnianami	kolnianin	subst:pl:inst:m1	nazwa pospolita	
> kolnianie	kolnianin	subst:pl:nom.voc:m1	nazwa pospolita	
> kolnianina	kolnianin	subst:sg:gen.acc:m1	nazwa pospolita	
> kolnianinem	kolnianin	subst:sg:inst:m1	nazwa pospolita	
> kolnianinie	kolnianin	subst:sg:loc:m1	nazwa pospolita	
> kolnianinie	kolnianin	subst:sg:voc:m1	nazwa pospolita	
> kolnianin	kolnianin	subst:sg:nom:m1	nazwa pospolita	
> kolnianinowi	kolnianin	subst:sg:dat:m1	nazwa pospolita	
> kolnian	kolnianin	subst:pl:gen.acc:m1	nazwa pospolita	
> kolnianom	kolnianin	subst:pl:dat:m1	nazwa pospolita	
> kolniany	kolnianin	depr:pl:nom.acc.voc:m2	nazwa pospolita	
> kolniance	kolnianka	subst:sg:dat.loc:f	nazwa pospolita	
> kolnianek	kolnianka	subst:pl:gen:f	nazwa pospolita	
> kolniankach	kolnianka	subst:pl:loc:f	nazwa pospolita	
> kolnianka	kolnianka	subst:sg:nom:f	nazwa pospolita	
> kolniankami	kolnianka	subst:pl:inst:f	nazwa pospolita	
> kolnianką	kolnianka	subst:sg:inst:f	nazwa pospolita	
> kolniankę	kolnianka	subst:sg:acc:f	nazwa pospolita	
> kolnianki	kolnianka	subst:pl:nom.acc.voc:f	nazwa pospolita	
> kolnianki	kolnianka	subst:sg:gen:f	nazwa pospolita	
> kolnianko	kolnianka	subst:sg:voc:f	nazwa pospolita	
> kolniankom	kolnianka	subst:pl:dat:f	nazwa pospolita	
> Kolnach	Kolno	subst:pl:loc:n:ncol	nazwa geograficzna	
> Kolna	Kolno	subst:pl:nom.acc.voc:n:ncol	nazwa geograficzna	
> Kolna	Kolno	subst:sg:gen:n:ncol	nazwa geograficzna	
> Kolnami	Kolno	subst:pl:inst:n:ncol	nazwa geograficzna	
> Kolnem	Kolno	subst:sg:inst:n:ncol	nazwa geograficzna	
> Kolnie	Kolno	subst:sg:loc:n:ncol	nazwa geograficzna	
> Koln	Kolno	subst:pl:gen:n:ncol	nazwa geograficzna	
> Kolno	Kolno	subst:sg:nom.acc.voc:n:ncol	nazwa geograficzna	
> Kolnom	Kolno	subst:pl:dat:n:ncol	nazwa geograficzna	
> Kolnu	Kolno	subst:sg:dat:n:ncol	nazwa geograficzna	
1504891a1505422,1505432
> Kościanach	Kościan:s1	subst:pl:loc:m3	nazwa geograficzna	
> Kościana	Kościan:s1	subst:sg:gen:m3	nazwa geograficzna	
> Kościanami	Kościan:s1	subst:pl:inst:m3	nazwa geograficzna	
> Kościanem	Kościan:s1	subst:sg:inst:m3	nazwa geograficzna	
> Kościanie	Kościan:s1	subst:sg:loc:m3	nazwa geograficzna	
> Kościanie	Kościan:s1	subst:sg:voc:m3	nazwa geograficzna	
> Kościan	Kościan:s1	subst:sg:nom.acc:m3	nazwa geograficzna	
> Kościanom	Kościan:s1	subst:pl:dat:m3	nazwa geograficzna	
> Kościanowi	Kościan:s1	subst:sg:dat:m3	nazwa geograficzna	
> Kościanów	Kościan:s1	subst:pl:gen:m3	nazwa geograficzna	
> Kościany	Kościan:s1	subst:pl:nom.acc.voc:m3	nazwa geograficzna	
1543404a1543946,1543968
> krośnianach	krośnianin	subst:pl:loc:m1	nazwa pospolita	
> krośnianami	krośnianin	subst:pl:inst:m1	nazwa pospolita	
> krośnianie	krośnianin	subst:pl:nom.voc:m1	nazwa pospolita	
> krośnianina	krośnianin	subst:sg:gen.acc:m1	nazwa pospolita	
> krośnianinem	krośnianin	subst:sg:inst:m1	nazwa pospolita	
> krośnianinie	krośnianin	subst:sg:loc:m1	nazwa pospolita	
> krośnianinie	krośnianin	subst:sg:voc:m1	nazwa pospolita	
> krośnianin	krośnianin	subst:sg:nom:m1	nazwa pospolita	
> krośnianinowi	krośnianin	subst:sg:dat:m1	nazwa pospolita	
> krośnian	krośnianin	subst:pl:gen.acc:m1	nazwa pospolita	
> krośnianom	krośnianin	subst:pl:dat:m1	nazwa pospolita	
> krośniany	krośnianin	depr:pl:nom.acc.voc:m2	nazwa pospolita	
> krośniance	krośnianka	subst:sg:dat.loc:f	nazwa pospolita	
> krośnianek	krośnianka	subst:pl:gen:f	nazwa pospolita	
> krośniankach	krośnianka	subst:pl:loc:f	nazwa pospolita	
> krośnianka	krośnianka	subst:sg:nom:f	nazwa pospolita	
> krośniankami	krośnianka	subst:pl:inst:f	nazwa pospolita	
> krośnianką	krośnianka	subst:sg:inst:f	nazwa pospolita	
> krośniankę	krośnianka	subst:sg:acc:f	nazwa pospolita	
> krośnianki	krośnianka	subst:pl:nom.acc.voc:f	nazwa pospolita	
> krośnianki	krośnianka	subst:sg:gen:f	nazwa pospolita	
> krośnianko	krośnianka	subst:sg:voc:f	nazwa pospolita	
> krośniankom	krośnianka	subst:pl:dat:f	nazwa pospolita	
1670629a1671194,1671216
> lidzbarczanach	lidzbarczanin	subst:pl:loc:m1	nazwa pospolita	
> lidzbarczanami	lidzbarczanin	subst:pl:inst:m1	nazwa pospolita	
> lidzbarczanie	lidzbarczanin	subst:pl:nom.voc:m1	nazwa pospolita	
> lidzbarczanina	lidzbarczanin	subst:sg:gen.acc:m1	nazwa pospolita	
> lidzbarczaninem	lidzbarczanin	subst:sg:inst:m1	nazwa pospolita	
> lidzbarczaninie	lidzbarczanin	subst:sg:loc:m1	nazwa pospolita	
> lidzbarczaninie	lidzbarczanin	subst:sg:voc:m1	nazwa pospolita	
> lidzbarczanin	lidzbarczanin	subst:sg:nom:m1	nazwa pospolita	
> lidzbarczaninowi	lidzbarczanin	subst:sg:dat:m1	nazwa pospolita	
> lidzbarczan	lidzbarczanin	subst:pl:gen.acc:m1	nazwa pospolita	
> lidzbarczanom	lidzbarczanin	subst:pl:dat:m1	nazwa pospolita	
> lidzbarczany	lidzbarczanin	depr:pl:nom.acc.voc:m2	nazwa pospolita	
> lidzbarczance	lidzbarczanka	subst:sg:dat.loc:f	nazwa pospolita	
> lidzbarczanek	lidzbarczanka	subst:pl:gen:f	nazwa pospolita	
> lidzbarczankach	lidzbarczanka	subst:pl:loc:f	nazwa pospolita	
> lidzbarczanka	lidzbarczanka	subst:sg:nom:f	nazwa pospolita	
> lidzbarczankami	lidzbarczanka	subst:pl:inst:f	nazwa pospolita	
> lidzbarczanką	lidzbarczanka	subst:sg:inst:f	nazwa pospolita	
> lidzbarczankę	lidzbarczanka	subst:sg:acc:f	nazwa pospolita	
> lidzbarczanki	lidzbarczanka	subst:pl:nom.acc.voc:f	nazwa pospolita	
> lidzbarczanki	lidzbarczanka	subst:sg:gen:f	nazwa pospolita	
> lidzbarczanko	lidzbarczanka	subst:sg:voc:f	nazwa pospolita	
> lidzbarczankom	lidzbarczanka	subst:pl:dat:f	nazwa pospolita	
1678924a1679512,1679521
> Lipnach	Lipno	subst:pl:loc:n:ncol	nazwa geograficzna	
> Lipna	Lipno	subst:pl:nom.acc.voc:n:ncol	nazwa geograficzna	
> Lipna	Lipno	subst:sg:gen:n:ncol	nazwa geograficzna	
> Lipnami	Lipno	subst:pl:inst:n:ncol	nazwa geograficzna	
> Lipnem	Lipno	subst:sg:inst:n:ncol	nazwa geograficzna	
> Lipnie	Lipno	subst:sg:loc:n:ncol	nazwa geograficzna	
> Lipn	Lipno	subst:pl:gen:n:ncol	nazwa geograficzna	
> Lipno	Lipno	subst:sg:nom.acc.voc:n:ncol	nazwa geograficzna	
> Lipnom	Lipno	subst:pl:dat:n:ncol	nazwa geograficzna	
> Lipnu	Lipno	subst:sg:dat:n:ncol	nazwa geograficzna	
1711655a1712253,1712275
> lwówczanach	lwówczanin	subst:pl:loc:m1	nazwa pospolita	
> lwówczanami	lwówczanin	subst:pl:inst:m1	nazwa pospolita	
> lwówczanie	lwówczanin	subst:pl:nom.voc:m1	nazwa pospolita	
> lwówczanina	lwówczanin	subst:sg:gen.acc:m1	nazwa pospolita	
> lwówczaninem	lwówczanin	subst:sg:inst:m1	nazwa pospolita	
> lwówczaninie	lwówczanin	subst:sg:loc:m1	nazwa pospolita	
> lwówczaninie	lwówczanin	subst:sg:voc:m1	nazwa pospolita	
> lwówczanin	lwówczanin	subst:sg:nom:m1	nazwa pospolita	
> lwówczaninowi	lwówczanin	subst:sg:dat:m1	nazwa pospolita	
> lwówczan	lwówczanin	subst:pl:gen.acc:m1	nazwa pospolita	
> lwówczanom	lwówczanin	subst:pl:dat:m1	nazwa pospolita	
> lwówczany	lwówczanin	depr:pl:nom.acc.voc:m2	nazwa pospolita	
> lwówczance	lwówczanka	subst:sg:dat.loc:f	nazwa pospolita	
> lwówczanek	lwówczanka	subst:pl:gen:f	nazwa pospolita	
> lwówczankach	lwówczanka	subst:pl:loc:f	nazwa pospolita	
> lwówczanka	lwówczanka	subst:sg:nom:f	nazwa pospolita	
> lwówczankami	lwówczanka	subst:pl:inst:f	nazwa pospolita	
> lwówczanką	lwówczanka	subst:sg:inst:f	nazwa pospolita	
> lwówczankę	lwówczanka	subst:sg:acc:f	nazwa pospolita	
> lwówczanki	lwówczanka	subst:pl:nom.acc.voc:f	nazwa pospolita	
> lwówczanki	lwówczanka	subst:sg:gen:f	nazwa pospolita	
> lwówczanko	lwówczanka	subst:sg:voc:f	nazwa pospolita	
> lwówczankom	lwówczanka	subst:pl:dat:f	nazwa pospolita	
1772288a1772909,1772931
> makowianach	makowianin	subst:pl:loc:m1	nazwa pospolita	
> makowianami	makowianin	subst:pl:inst:m1	nazwa pospolita	
> makowianie	makowianin	subst:pl:nom.voc:m1	nazwa pospolita	
> makowianina	makowianin	subst:sg:gen.acc:m1	nazwa pospolita	
> makowianinem	makowianin	subst:sg:inst:m1	nazwa pospolita	
> makowianinie	makowianin	subst:sg:loc:m1	nazwa pospolita	
> makowianinie	makowianin	subst:sg:voc:m1	nazwa pospolita	
> makowianin	makowianin	subst:sg:nom:m1	nazwa pospolita	
> makowianinowi	makowianin	subst:sg:dat:m1	nazwa pospolita	
> makowian	makowianin	subst:pl:gen.acc:m1	nazwa pospolita	
> makowianom	makowianin	subst:pl:dat:m1	nazwa pospolita	
> makowiany	makowianin	depr:pl:nom.acc.voc:m2	nazwa pospolita	
> makowiance	makowianka	subst:sg:dat.loc:f	nazwa pospolita	
> makowianek	makowianka	subst:pl:gen:f	nazwa pospolita	
> makowiankach	makowianka	subst:pl:loc:f	nazwa pospolita	
> makowianka	makowianka	subst:sg:nom:f	nazwa pospolita	
> makowiankami	makowianka	subst:pl:inst:f	nazwa pospolita	
> makowianką	makowianka	subst:sg:inst:f	nazwa pospolita	
> makowiankę	makowianka	subst:sg:acc:f	nazwa pospolita	
> makowianki	makowianka	subst:pl:nom.acc.voc:f	nazwa pospolita	
> makowianki	makowianka	subst:sg:gen:f	nazwa pospolita	
> makowianko	makowianka	subst:sg:voc:f	nazwa pospolita	
> makowiankom	makowianka	subst:pl:dat:f	nazwa pospolita	
1832131a1832775,1832797
> mediolance	mediolanka	subst:sg:dat.loc:f	nazwa pospolita	
> mediolanek	mediolanka	subst:pl:gen:f	nazwa pospolita	
> mediolankach	mediolanka	subst:pl:loc:f	nazwa pospolita	
> mediolanka	mediolanka	subst:sg:nom:f	nazwa pospolita	
> mediolankami	mediolanka	subst:pl:inst:f	nazwa pospolita	
> mediolanką	mediolanka	subst:sg:inst:f	nazwa pospolita	
> mediolankę	mediolanka	subst:sg:acc:f	nazwa pospolita	
> mediolanki	mediolanka	subst:pl:nom.acc.voc:f	nazwa pospolita	
> mediolanki	mediolanka	subst:sg:gen:f	nazwa pospolita	
> mediolanko	mediolanka	subst:sg:voc:f	nazwa pospolita	
> mediolankom	mediolanka	subst:pl:dat:f	nazwa pospolita	
> mediolańczycy	mediolańczyk	subst:pl:nom.voc:m1	nazwa pospolita	
> mediolańczykach	mediolańczyk	subst:pl:loc:m1	nazwa pospolita	
> mediolańczyka	mediolańczyk	subst:sg:gen.acc:m1	nazwa pospolita	
> mediolańczykami	mediolańczyk	subst:pl:inst:m1	nazwa pospolita	
> mediolańczykiem	mediolańczyk	subst:sg:inst:m1	nazwa pospolita	
> mediolańczyki	mediolańczyk	depr:pl:nom.acc.voc:m2	nazwa pospolita	
> mediolańczyk	mediolańczyk	subst:sg:nom:m1	nazwa pospolita	
> mediolańczykom	mediolańczyk	subst:pl:dat:m1	nazwa pospolita	
> mediolańczykowi	mediolańczyk	subst:sg:dat:m1	nazwa pospolita	
> mediolańczyków	mediolańczyk	subst:pl:gen.acc:m1	nazwa pospolita	
> mediolańczyku	mediolańczyk	subst:sg:loc:m1	nazwa pospolita	
> mediolańczyku	mediolańczyk	subst:sg:voc:m1	nazwa pospolita	
1921740a1922407,1922429
> mogilnianach	mogilnianin	subst:pl:loc:m1	nazwa pospolita	
> mogilnianami	mogilnianin	subst:pl:inst:m1	nazwa pospolita	
> mogilnianie	mogilnianin	subst:pl:nom.voc:m1	nazwa pospolita	
> mogilnianina	mogilnianin	subst:sg:gen.acc:m1	nazwa pospolita	
> mogilnianinem	mogilnianin	subst:sg:inst:m1	nazwa pospolita	
> mogilnianinie	mogilnianin	subst:sg:loc:m1	nazwa pospolita	
> mogilnianinie	mogilnianin	subst:sg:voc:m1	nazwa pospolita	
> mogilnianin	mogilnianin	subst:sg:nom:m1	nazwa pospolita	
> mogilnianinowi	mogilnianin	subst:sg:dat:m1	nazwa pospolita	
> mogilnian	mogilnianin	subst:pl:gen.acc:m1	nazwa pospolita	
> mogilnianom	mogilnianin	subst:pl:dat:m1	nazwa pospolita	
> mogilniany	mogilnianin	depr:pl:nom.acc.voc:m2	nazwa pospolita	
> mogilniance	mogilnianka	subst:sg:dat.loc:f	nazwa pospolita	
> mogilnianek	mogilnianka	subst:pl:gen:f	nazwa pospolita	
> mogilniankach	mogilnianka	subst:pl:loc:f	nazwa pospolita	
> mogilniankami	mogilnianka	subst:pl:inst:f	nazwa pospolita	
> mogilnianka	mogilnianka	subst:sg:nom:f	nazwa pospolita	
> mogilnianką	mogilnianka	subst:sg:inst:f	nazwa pospolita	
> mogilniankę	mogilnianka	subst:sg:acc:f	nazwa pospolita	
> mogilnianki	mogilnianka	subst:pl:nom.acc.voc:f	nazwa pospolita	
> mogilnianki	mogilnianka	subst:sg:gen:f	nazwa pospolita	
> mogilniankom	mogilnianka	subst:pl:dat:f	nazwa pospolita	
> mogilnianko	mogilnianka	subst:sg:voc:f	nazwa pospolita	
1921774a1922464,1922473
> Mogilnach	Mogilno	subst:pl:loc:n:ncol	nazwa geograficzna	
> Mogilnami	Mogilno	subst:pl:inst:n:ncol	nazwa geograficzna	
> Mogilna	Mogilno	subst:pl:nom.acc.voc:n:ncol	nazwa geograficzna	
> Mogilna	Mogilno	subst:sg:gen:n:ncol	nazwa geograficzna	
> Mogilnem	Mogilno	subst:sg:inst:n:ncol	nazwa geograficzna	
> Mogilnie	Mogilno	subst:sg:loc:n:ncol	nazwa geograficzna	
> Mogiln	Mogilno	subst:pl:gen:n:ncol	nazwa geograficzna	
> Mogilnom	Mogilno	subst:pl:dat:n:ncol	nazwa geograficzna	
> Mogilno	Mogilno	subst:sg:nom.acc.voc:n:ncol	nazwa geograficzna	
> Mogilnu	Mogilno	subst:sg:dat:n:ncol	nazwa geograficzna	
3335265a3335965,3335976
> nowodworzanach	nowodworzanin	subst:pl:loc:m1	nazwa pospolita	
> nowodworzanami	nowodworzanin	subst:pl:inst:m1	nazwa pospolita	
> nowodworzanie	nowodworzanin	subst:pl:nom.voc:m1	nazwa pospolita	
> nowodworzanina	nowodworzanin	subst:sg:gen.acc:m1	nazwa pospolita	
> nowodworzaninem	nowodworzanin	subst:sg:inst:m1	nazwa pospolita	
> nowodworzaninie	nowodworzanin	subst:sg:loc:m1	nazwa pospolita	
> nowodworzaninie	nowodworzanin	subst:sg:voc:m1	nazwa pospolita	
> nowodworzanin	nowodworzanin	subst:sg:nom:m1	nazwa pospolita	
> nowodworzaninowi	nowodworzanin	subst:sg:dat:m1	nazwa pospolita	
> nowodworzan	nowodworzanin	subst:pl:gen.acc:m1	nazwa pospolita	
> nowodworzanom	nowodworzanin	subst:pl:dat:m1	nazwa pospolita	
> nowodworzany	nowodworzanin	depr:pl:nom.acc.voc:m2	nazwa pospolita	
3337668a3338380,3338402
> nowotarżanach	nowotarżanin	subst:pl:loc:m1	nazwa pospolita	
> nowotarżanami	nowotarżanin	subst:pl:inst:m1	nazwa pospolita	
> nowotarżanie	nowotarżanin	subst:pl:nom.voc:m1	nazwa pospolita	
> nowotarżanina	nowotarżanin	subst:sg:gen.acc:m1	nazwa pospolita	
> nowotarżaninem	nowotarżanin	subst:sg:inst:m1	nazwa pospolita	
> nowotarżaninie	nowotarżanin	subst:sg:loc:m1	nazwa pospolita	
> nowotarżaninie	nowotarżanin	subst:sg:voc:m1	nazwa pospolita	
> nowotarżanin	nowotarżanin	subst:sg:nom:m1	nazwa pospolita	
> nowotarżaninowi	nowotarżanin	subst:sg:dat:m1	nazwa pospolita	
> nowotarżan	nowotarżanin	subst:pl:gen.acc:m1	nazwa pospolita	
> nowotarżanom	nowotarżanin	subst:pl:dat:m1	nazwa pospolita	
> nowotarżany	nowotarżanin	depr:pl:nom.acc.voc:m2	nazwa pospolita	
> nowotarżance	nowotarżanka	subst:sg:dat.loc:f	nazwa pospolita	
> nowotarżanek	nowotarżanka	subst:pl:gen:f	nazwa pospolita	
> nowotarżankach	nowotarżanka	subst:pl:loc:f	nazwa pospolita	
> nowotarżankami	nowotarżanka	subst:pl:inst:f	nazwa pospolita	
> nowotarżanka	nowotarżanka	subst:sg:nom:f	nazwa pospolita	
> nowotarżanką	nowotarżanka	subst:sg:inst:f	nazwa pospolita	
> nowotarżankę	nowotarżanka	subst:sg:acc:f	nazwa pospolita	
> nowotarżanki	nowotarżanka	subst:pl:nom.acc.voc:f	nazwa pospolita	
> nowotarżanki	nowotarżanka	subst:sg:gen:f	nazwa pospolita	
> nowotarżankom	nowotarżanka	subst:pl:dat:f	nazwa pospolita	
> nowotarżanko	nowotarżanka	subst:sg:voc:f	nazwa pospolita	
3337897a3338632,3338654
> nowotomyślanach	nowotomyślanin	subst:pl:loc:m1	nazwa pospolita	
> nowotomyślanami	nowotomyślanin	subst:pl:inst:m1	nazwa pospolita	
> nowotomyślanie	nowotomyślanin	subst:pl:nom.voc:m1	nazwa pospolita	
> nowotomyślanina	nowotomyślanin	subst:sg:gen.acc:m1	nazwa pospolita	
> nowotomyślaninem	nowotomyślanin	subst:sg:inst:m1	nazwa pospolita	
> nowotomyślaninie	nowotomyślanin	subst:sg:loc:m1	nazwa pospolita	
> nowotomyślaninie	nowotomyślanin	subst:sg:voc:m1	nazwa pospolita	
> nowotomyślanin	nowotomyślanin	subst:sg:nom:m1	nazwa pospolita	
> nowotomyślaninowi	nowotomyślanin	subst:sg:dat:m1	nazwa pospolita	
> nowotomyślan	nowotomyślanin	subst:pl:gen.acc:m1	nazwa pospolita	
> nowotomyślanom	nowotomyślanin	subst:pl:dat:m1	nazwa pospolita	
> nowotomyślany	nowotomyślanin	depr:pl:nom.acc.voc:m2	nazwa pospolita	
> nowotomyślance	nowotomyślanka	subst:sg:dat.loc:f	nazwa pospolita	
> nowotomyślanek	nowotomyślanka	subst:pl:gen:f	nazwa pospolita	
> nowotomyślankach	nowotomyślanka	subst:pl:loc:f	nazwa pospolita	
> nowotomyślankami	nowotomyślanka	subst:pl:inst:f	nazwa pospolita	
> nowotomyślanka	nowotomyślanka	subst:sg:nom:f	nazwa pospolita	
> nowotomyślanką	nowotomyślanka	subst:sg:inst:f	nazwa pospolita	
> nowotomyślankę	nowotomyślanka	subst:sg:acc:f	nazwa pospolita	
> nowotomyślanki	nowotomyślanka	subst:pl:nom.acc.voc:f	nazwa pospolita	
> nowotomyślanki	nowotomyślanka	subst:sg:gen:f	nazwa pospolita	
> nowotomyślankom	nowotomyślanka	subst:pl:dat:f	nazwa pospolita	
> nowotomyślanko	nowotomyślanka	subst:sg:voc:f	nazwa pospolita	
3656040a3656798,3656807
> Olesien	Olesno	subst:pl:gen:n:ncol	nazwa geograficzna	
> Olesnach	Olesno	subst:pl:loc:n:ncol	nazwa geograficzna	
> Olesnami	Olesno	subst:pl:inst:n:ncol	nazwa geograficzna	
> Olesna	Olesno	subst:pl:nom.acc.voc:n:ncol	nazwa geograficzna	
> Olesna	Olesno	subst:sg:gen:n:ncol	nazwa geograficzna	
> Olesnem	Olesno	subst:sg:inst:n:ncol	nazwa geograficzna	
> Olesnom	Olesno	subst:pl:dat:n:ncol	nazwa geograficzna	
> Olesno	Olesno	subst:sg:nom.acc.voc:n:ncol	nazwa geograficzna	
> Olesnu	Olesno	subst:sg:dat:n:ncol	nazwa geograficzna	
> Oleśnie	Olesno	subst:sg:loc:n:ncol	nazwa geograficzna	
3658600a3659368,3659390
> olkuszanach	olkuszanin	subst:pl:loc:m1	nazwa pospolita	
> olkuszanami	olkuszanin	subst:pl:inst:m1	nazwa pospolita	
> olkuszanie	olkuszanin	subst:pl:nom.voc:m1	nazwa pospolita	
> olkuszanina	olkuszanin	subst:sg:gen.acc:m1	nazwa pospolita	
> olkuszaninem	olkuszanin	subst:sg:inst:m1	nazwa pospolita	
> olkuszaninie	olkuszanin	subst:sg:loc:m1	nazwa pospolita	
> olkuszaninie	olkuszanin	subst:sg:voc:m1	nazwa pospolita	
> olkuszanin	olkuszanin	subst:sg:nom:m1	nazwa pospolita	
> olkuszaninowi	olkuszanin	subst:sg:dat:m1	nazwa pospolita	
> olkuszan	olkuszanin	subst:pl:gen.acc:m1	nazwa pospolita	
> olkuszanom	olkuszanin	subst:pl:dat:m1	nazwa pospolita	
> olkuszany	olkuszanin	depr:pl:nom.acc.voc:m2	nazwa pospolita	
> olkuszance	olkuszanka	subst:sg:dat.loc:f	nazwa pospolita	
> olkuszanek	olkuszanka	subst:pl:gen:f	nazwa pospolita	
> olkuszankach	olkuszanka	subst:pl:loc:f	nazwa pospolita	
> olkuszankami	olkuszanka	subst:pl:inst:f	nazwa pospolita	
> olkuszanka	olkuszanka	subst:sg:nom:f	nazwa pospolita	
> olkuszanką	olkuszanka	subst:sg:inst:f	nazwa pospolita	
> olkuszankę	olkuszanka	subst:sg:acc:f	nazwa pospolita	
> olkuszanki	olkuszanka	subst:pl:nom.acc.voc:f	nazwa pospolita	
> olkuszanki	olkuszanka	subst:sg:gen:f	nazwa pospolita	
> olkuszankom	olkuszanka	subst:pl:dat:f	nazwa pospolita	
> olkuszanko	olkuszanka	subst:sg:voc:f	nazwa pospolita	
3750029a3750820,3750842
> ostrowczanach	ostrowczanin	subst:pl:loc:m1	nazwa pospolita	
> ostrowczanami	ostrowczanin	subst:pl:inst:m1	nazwa pospolita	
> ostrowczanie	ostrowczanin	subst:pl:nom.voc:m1	nazwa pospolita	
> ostrowczanina	ostrowczanin	subst:sg:gen.acc:m1	nazwa pospolita	
> ostrowczaninem	ostrowczanin	subst:sg:inst:m1	nazwa pospolita	
> ostrowczaninie	ostrowczanin	subst:sg:loc:m1	nazwa pospolita	
> ostrowczaninie	ostrowczanin	subst:sg:voc:m1	nazwa pospolita	
> ostrowczanin	ostrowczanin	subst:sg:nom:m1	nazwa pospolita	
> ostrowczaninowi	ostrowczanin	subst:sg:dat:m1	nazwa pospolita	
> ostrowczanom	ostrowczanin	subst:pl:dat:m1	nazwa pospolita	
> ostrowczan	ostrowczanin	subst:pl:gen.acc:m1	nazwa pospolita	
> ostrowczany	ostrowczanin	depr:pl:nom.acc.voc:m2	nazwa pospolita	
> ostrowczance	ostrowczanka	subst:sg:dat.loc:f	nazwa pospolita	
> ostrowczanek	ostrowczanka	subst:pl:gen:f	nazwa pospolita	
> ostrowczankach	ostrowczanka	subst:pl:loc:f	nazwa pospolita	
> ostrowczankami	ostrowczanka	subst:pl:inst:f	nazwa pospolita	
> ostrowczanka	ostrowczanka	subst:sg:nom:f	nazwa pospolita	
> ostrowczanką	ostrowczanka	subst:sg:inst:f	nazwa pospolita	
> ostrowczankę	ostrowczanka	subst:sg:acc:f	nazwa pospolita	
> ostrowczanki	ostrowczanka	subst:pl:nom.acc.voc:f	nazwa pospolita	
> ostrowczanki	ostrowczanka	subst:sg:gen:f	nazwa pospolita	
> ostrowczankom	ostrowczanka	subst:pl:dat:f	nazwa pospolita	
> ostrowczanko	ostrowczanka	subst:sg:voc:f	nazwa pospolita	
3750040a3750854,3750876
> ostrowianach	ostrowianin	subst:pl:loc:m1	nazwa pospolita	
> ostrowianami	ostrowianin	subst:pl:inst:m1	nazwa pospolita	
> ostrowianie	ostrowianin	subst:pl:nom.voc:m1	nazwa pospolita	
> ostrowianina	ostrowianin	subst:sg:gen.acc:m1	nazwa pospolita	
> ostrowianinem	ostrowianin	subst:sg:inst:m1	nazwa pospolita	
> ostrowianinie	ostrowianin	subst:sg:loc:m1	nazwa pospolita	
> ostrowianinie	ostrowianin	subst:sg:voc:m1	nazwa pospolita	
> ostrowianin	ostrowianin	subst:sg:nom:m1	nazwa pospolita	
> ostrowianinowi	ostrowianin	subst:sg:dat:m1	nazwa pospolita	
> ostrowianom	ostrowianin	subst:pl:dat:m1	nazwa pospolita	
> ostrowian	ostrowianin	subst:pl:gen.acc:m1	nazwa pospolita	
> ostrowiany	ostrowianin	depr:pl:nom.acc.voc:m2	nazwa pospolita	
> ostrowiance	ostrowianka	subst:sg:dat.loc:f	nazwa pospolita	
> ostrowianek	ostrowianka	subst:pl:gen:f	nazwa pospolita	
> ostrowiankach	ostrowianka	subst:pl:loc:f	nazwa pospolita	
> ostrowiankami	ostrowianka	subst:pl:inst:f	nazwa pospolita	
> ostrowianka	ostrowianka	subst:sg:nom:f	nazwa pospolita	
> ostrowianką	ostrowianka	subst:sg:inst:f	nazwa pospolita	
> ostrowiankę	ostrowianka	subst:sg:acc:f	nazwa pospolita	
> ostrowianki	ostrowianka	subst:pl:nom.acc.voc:f	nazwa pospolita	
> ostrowianki	ostrowianka	subst:sg:gen:f	nazwa pospolita	
> ostrowiankom	ostrowianka	subst:pl:dat:f	nazwa pospolita	
> ostrowianko	ostrowianka	subst:sg:voc:f	nazwa pospolita	
3807458a3808295,3808304
> Pajęcznach	Pajęczno	subst:pl:loc:n:ncol	nazwa geograficzna	
> Pajęcznami	Pajęczno	subst:pl:inst:n:ncol	nazwa geograficzna	
> Pajęczna	Pajęczno	subst:pl:nom.acc.voc:n:ncol	nazwa geograficzna	
> Pajęczna	Pajęczno	subst:sg:gen:n:ncol	nazwa geograficzna	
> Pajęcznem	Pajęczno	subst:sg:inst:n:ncol	nazwa geograficzna	
> Pajęcznie	Pajęczno	subst:sg:loc:n:ncol	nazwa geograficzna	
> Pajęcznom	Pajęczno	subst:pl:dat:n:ncol	nazwa geograficzna	
> Pajęczno	Pajęczno	subst:sg:nom.acc.voc:n:ncol	nazwa geograficzna	
> Pajęczn	Pajęczno	subst:pl:gen:n:ncol	nazwa geograficzna	
> Pajęcznu	Pajęczno	subst:sg:dat:n:ncol	nazwa geograficzna	
3876880a3877727,3877738
> Pepiczek	Pepiczek	subst:sg:nom:m1	nazwa pospolita	pot.
> Pepiczkach	Pepiczek	subst:pl:loc:m1	nazwa pospolita	pot.
> Pepiczkami	Pepiczek	subst:pl:inst:m1	nazwa pospolita	pot.
> Pepiczka	Pepiczek	subst:sg:gen.acc:m1	nazwa pospolita	pot.
> Pepiczkiem	Pepiczek	subst:sg:inst:m1	nazwa pospolita	pot.
> Pepiczki	Pepiczek	depr:pl:nom.acc.voc:m2	nazwa pospolita	pot.
> Pepiczkom	Pepiczek	subst:pl:dat:m1	nazwa pospolita	pot.
> Pepiczkowie	Pepiczek	subst:pl:nom.voc:m1	nazwa pospolita	pot.
> Pepiczkowi	Pepiczek	subst:sg:dat:m1	nazwa pospolita	pot.
> Pepiczków	Pepiczek	subst:pl:gen.acc:m1	nazwa pospolita	pot.
> Pepiczku	Pepiczek	subst:sg:loc:m1	nazwa pospolita	pot.
> Pepiczku	Pepiczek	subst:sg:voc:m1	nazwa pospolita	pot.
3876891a3877750,3877760
> Pepiczce	Pepiczka	subst:sg:dat.loc:f	nazwa pospolita	pot.
> Pepiczek	Pepiczka	subst:pl:gen:f	nazwa pospolita	pot.
> Pepiczkach	Pepiczka	subst:pl:loc:f	nazwa pospolita	pot.
> Pepiczkami	Pepiczka	subst:pl:inst:f	nazwa pospolita	pot.
> Pepiczka	Pepiczka	subst:sg:nom:f	nazwa pospolita	pot.
> Pepiczką	Pepiczka	subst:sg:inst:f	nazwa pospolita	pot.
> Pepiczkę	Pepiczka	subst:sg:acc:f	nazwa pospolita	pot.
> Pepiczki	Pepiczka	subst:pl:nom.acc.voc:f	nazwa pospolita	pot.
> Pepiczki	Pepiczka	subst:sg:gen:f	nazwa pospolita	pot.
> Pepiczkom	Pepiczka	subst:pl:dat:f	nazwa pospolita	pot.
> Pepiczko	Pepiczka	subst:sg:voc:f	nazwa pospolita	pot.
3882894a3883764,3883774
> Persjance	Persjanka	subst:sg:dat.loc:f	nazwa pospolita	etn.
> Persjanek	Persjanka	subst:pl:gen:f	nazwa pospolita	etn.
> Persjankach	Persjanka	subst:pl:loc:f	nazwa pospolita	etn.
> Persjankami	Persjanka	subst:pl:inst:f	nazwa pospolita	etn.
> Persjanka	Persjanka	subst:sg:nom:f	nazwa pospolita	etn.
> Persjanką	Persjanka	subst:sg:inst:f	nazwa pospolita	etn.
> Persjankę	Persjanka	subst:sg:acc:f	nazwa pospolita	etn.
> Persjanki	Persjanka	subst:pl:nom.acc.voc:f	nazwa pospolita	etn.
> Persjanki	Persjanka	subst:sg:gen:f	nazwa pospolita	etn.
> Persjankom	Persjanka	subst:pl:dat:f	nazwa pospolita	etn.
> Persjanko	Persjanka	subst:sg:voc:f	nazwa pospolita	etn.
3901000a3901881,3901903
> piekarnianach	piekarnianin	subst:pl:loc:m1	nazwa pospolita	
> piekarnianami	piekarnianin	subst:pl:inst:m1	nazwa pospolita	
> piekarnianie	piekarnianin	subst:pl:nom.voc:m1	nazwa pospolita	
> piekarnianina	piekarnianin	subst:sg:gen.acc:m1	nazwa pospolita	
> piekarnianinem	piekarnianin	subst:sg:inst:m1	nazwa pospolita	
> piekarnianinie	piekarnianin	subst:sg:loc:m1	nazwa pospolita	
> piekarnianinie	piekarnianin	subst:sg:voc:m1	nazwa pospolita	
> piekarnianinowi	piekarnianin	subst:sg:dat:m1	nazwa pospolita	
> piekarnianin	piekarnianin	subst:sg:nom:m1	nazwa pospolita	
> piekarnianom	piekarnianin	subst:pl:dat:m1	nazwa pospolita	
> piekarnian	piekarnianin	subst:pl:gen.acc:m1	nazwa pospolita	
> piekarniany	piekarnianin	depr:pl:nom.acc.voc:m2	nazwa pospolita	
> piekarniance	piekarnianka	subst:sg:dat.loc:f	nazwa pospolita	
> piekarnianek	piekarnianka	subst:pl:gen:f	nazwa pospolita	
> piekarniankach	piekarnianka	subst:pl:loc:f	nazwa pospolita	
> piekarniankami	piekarnianka	subst:pl:inst:f	nazwa pospolita	
> piekarnianka	piekarnianka	subst:sg:nom:f	nazwa pospolita	
> piekarnianką	piekarnianka	subst:sg:inst:f	nazwa pospolita	
> piekarniankę	piekarnianka	subst:sg:acc:f	nazwa pospolita	
> piekarnianki	piekarnianka	subst:pl:nom.acc.voc:f	nazwa pospolita	
> piekarnianki	piekarnianka	subst:sg:gen:f	nazwa pospolita	
> piekarniankom	piekarnianka	subst:pl:dat:f	nazwa pospolita	
> piekarnianko	piekarnianka	subst:sg:voc:f	nazwa pospolita	
3950161a3951065,3951098
> Pleszewach	Pleszew	subst:pl:loc:m3	nazwa geograficzna	
> Pleszewami	Pleszew	subst:pl:inst:m3	nazwa geograficzna	
> Pleszewa	Pleszew	subst:sg:gen:m3	nazwa geograficzna	
> Pleszewem	Pleszew	subst:sg:inst:m3	nazwa geograficzna	
> Pleszewie	Pleszew	subst:sg:loc:m3	nazwa geograficzna	
> Pleszewie	Pleszew	subst:sg:voc:m3	nazwa geograficzna	
> Pleszewom	Pleszew	subst:pl:dat:m3	nazwa geograficzna	
> Pleszewowi	Pleszew	subst:sg:dat:m3	nazwa geograficzna	
> Pleszewów	Pleszew	subst:pl:gen:m3	nazwa geograficzna	
> Pleszew	Pleszew	subst:sg:nom.acc:m3	nazwa geograficzna	
> Pleszewy	Pleszew	subst:pl:nom.acc.voc:m3	nazwa geograficzna	
> pleszewianach	pleszewianin	subst:pl:loc:m1	nazwa pospolita	
> pleszewianami	pleszewianin	subst:pl:inst:m1	nazwa pospolita	
> pleszewianie	pleszewianin	subst:pl:nom.voc:m1	nazwa pospolita	
> pleszewianina	pleszewianin	subst:sg:gen.acc:m1	nazwa pospolita	
> pleszewianinem	pleszewianin	subst:sg:inst:m1	nazwa pospolita	
> pleszewianinie	pleszewianin	subst:sg:loc:m1	nazwa pospolita	
> pleszewianinie	pleszewianin	subst:sg:voc:m1	nazwa pospolita	
> pleszewianinowi	pleszewianin	subst:sg:dat:m1	nazwa pospolita	
> pleszewianin	pleszewianin	subst:sg:nom:m1	nazwa pospolita	
> pleszewianom	pleszewianin	subst:pl:dat:m1	nazwa pospolita	
> pleszewian	pleszewianin	subst:pl:gen.acc:m1	nazwa pospolita	
> pleszewiany	pleszewianin	depr:pl:nom.acc.voc:m2	nazwa pospolita	
> pleszewiance	pleszewianka	subst:sg:dat.loc:f	nazwa pospolita	
> pleszewianek	pleszewianka	subst:pl:gen:f	nazwa pospolita	
> pleszewiankach	pleszewianka	subst:pl:loc:f	nazwa pospolita	
> pleszewiankami	pleszewianka	subst:pl:inst:f	nazwa pospolita	
> pleszewianka	pleszewianka	subst:sg:nom:f	nazwa pospolita	
> pleszewianką	pleszewianka	subst:sg:inst:f	nazwa pospolita	
> pleszewiankę	pleszewianka	subst:sg:acc:f	nazwa pospolita	
> pleszewianki	pleszewianka	subst:pl:nom.acc.voc:f	nazwa pospolita	
> pleszewianki	pleszewianka	subst:sg:gen:f	nazwa pospolita	
> pleszewiankom	pleszewianka	subst:pl:dat:f	nazwa pospolita	
> pleszewianko	pleszewianka	subst:sg:voc:f	nazwa pospolita	
4147591a4148529,4148539
> polexicie	polexit	subst:sg:loc:m3	nazwa pospolita	
> polexicie	polexit	subst:sg:voc:m3	nazwa pospolita	
> polexitach	polexit	subst:pl:loc:m3	nazwa pospolita	
> polexitami	polexit	subst:pl:inst:m3	nazwa pospolita	
> polexitem	polexit	subst:sg:inst:m3	nazwa pospolita	
> polexitom	polexit	subst:pl:dat:m3	nazwa pospolita	
> polexitowi	polexit	subst:sg:dat:m3	nazwa pospolita	
> polexitów	polexit	subst:pl:gen:m3	nazwa pospolita	
> polexit	polexit	subst:sg:nom.acc:m3	nazwa pospolita	
> polexitu	polexit	subst:sg:gen:m3	nazwa pospolita	
> polexity	polexit	subst:pl:nom.acc.voc:m3	nazwa pospolita	
4481603a4482552,4482575
> Przasnyszach	Przasnysz	subst:pl:loc:m3	nazwa geograficzna	
> Przasnyszami	Przasnysz	subst:pl:inst:m3	nazwa geograficzna	
> Przasnyszem	Przasnysz	subst:sg:inst:m3	nazwa geograficzna	
> Przasnysze	Przasnysz	subst:pl:nom.acc.voc:m3	nazwa geograficzna	
> Przasnyszom	Przasnysz	subst:pl:dat:m3	nazwa geograficzna	
> Przasnyszowi	Przasnysz	subst:sg:dat:m3	nazwa geograficzna	
> Przasnyszów	Przasnysz	subst:pl:gen:m3	nazwa geograficzna	
> Przasnysz	Przasnysz	subst:sg:nom.acc:m3	nazwa geograficzna	
> Przasnyszu	Przasnysz	subst:sg:gen:m3	nazwa geograficzna	
> Przasnyszu	Przasnysz	subst:sg:loc:m3	nazwa geograficzna	
> Przasnyszu	Przasnysz	subst:sg:voc:m3	nazwa geograficzna	
> Przasnyszy	Przasnysz	subst:pl:gen:m3	nazwa geograficzna	
> przasnyszanach	przasnyszanin	subst:pl:loc:m1	nazwa pospolita	
> przasnyszanami	przasnyszanin	subst:pl:inst:m1	nazwa pospolita	
> przasnyszanie	przasnyszanin	subst:pl:nom.voc:m1	nazwa pospolita	
> przasnyszanina	przasnyszanin	subst:sg:gen.acc:m1	nazwa pospolita	
> przasnyszaninem	przasnyszanin	subst:sg:inst:m1	nazwa pospolita	
> przasnyszaninie	przasnyszanin	subst:sg:loc:m1	nazwa pospolita	
> przasnyszaninie	przasnyszanin	subst:sg:voc:m1	nazwa pospolita	
> przasnyszaninowi	przasnyszanin	subst:sg:dat:m1	nazwa pospolita	
> przasnyszanin	przasnyszanin	subst:sg:nom:m1	nazwa pospolita	
> przasnyszanom	przasnyszanin	subst:pl:dat:m1	nazwa pospolita	
> przasnyszan	przasnyszanin	subst:pl:gen.acc:m1	nazwa pospolita	
> przasnyszany	przasnyszanin	depr:pl:nom.acc.voc:m2	nazwa pospolita	
4765988a4766961,4766971
> Przysuchach	Przysucha:s1	subst:pl:loc:f	nazwa geograficzna	
> Przysuchami	Przysucha:s1	subst:pl:inst:f	nazwa geograficzna	
> Przysucha	Przysucha:s1	subst:sg:nom:f	nazwa geograficzna	
> Przysuchą	Przysucha:s1	subst:sg:inst:f	nazwa geograficzna	
> Przysuchę	Przysucha:s1	subst:sg:acc:f	nazwa geograficzna	
> Przysuchom	Przysucha:s1	subst:pl:dat:f	nazwa geograficzna	
> Przysucho	Przysucha:s1	subst:sg:voc:f	nazwa geograficzna	
> Przysuch	Przysucha:s1	subst:pl:gen:f	nazwa geograficzna	
> Przysuchy	Przysucha:s1	subst:pl:nom.acc.voc:f	nazwa geograficzna	
> Przysuchy	Przysucha:s1	subst:sg:gen:f	nazwa geograficzna	
> Przysusze	Przysucha:s1	subst:sg:dat.loc:f	nazwa geograficzna	
4766277a4767261,4767283
> przysuszanach	przysuszanin	subst:pl:loc:m1	nazwa pospolita	
> przysuszanami	przysuszanin	subst:pl:inst:m1	nazwa pospolita	
> przysuszanie	przysuszanin	subst:pl:nom.voc:m1	nazwa pospolita	
> przysuszanina	przysuszanin	subst:sg:gen.acc:m1	nazwa pospolita	
> przysuszaninem	przysuszanin	subst:sg:inst:m1	nazwa pospolita	
> przysuszaninie	przysuszanin	subst:sg:loc:m1	nazwa pospolita	
> przysuszaninie	przysuszanin	subst:sg:voc:m1	nazwa pospolita	
> przysuszaninowi	przysuszanin	subst:sg:dat:m1	nazwa pospolita	
> przysuszanin	przysuszanin	subst:sg:nom:m1	nazwa pospolita	
> przysuszanom	przysuszanin	subst:pl:dat:m1	nazwa pospolita	
> przysuszan	przysuszanin	subst:pl:gen.acc:m1	nazwa pospolita	
> przysuszany	przysuszanin	depr:pl:nom.acc.voc:m2	nazwa pospolita	
> przysuszance	przysuszanka	subst:sg:dat.loc:f	nazwa pospolita	
> przysuszanek	przysuszanka	subst:pl:gen:f	nazwa pospolita	
> przysuszankach	przysuszanka	subst:pl:loc:f	nazwa pospolita	
> przysuszankami	przysuszanka	subst:pl:inst:f	nazwa pospolita	
> przysuszanka	przysuszanka	subst:sg:nom:f	nazwa pospolita	
> przysuszanką	przysuszanka	subst:sg:inst:f	nazwa pospolita	
> przysuszankę	przysuszanka	subst:sg:acc:f	nazwa pospolita	
> przysuszanki	przysuszanka	subst:pl:nom.acc.voc:f	nazwa pospolita	
> przysuszanki	przysuszanka	subst:sg:gen:f	nazwa pospolita	
> przysuszankom	przysuszanka	subst:pl:dat:f	nazwa pospolita	
> przysuszanko	przysuszanka	subst:sg:voc:f	nazwa pospolita	
4799070a4800077,4800087
> Pszczynach	Pszczyna	subst:pl:loc:f	nazwa geograficzna	
> Pszczynami	Pszczyna	subst:pl:inst:f	nazwa geograficzna	
> Pszczyna	Pszczyna	subst:sg:nom:f	nazwa geograficzna	
> Pszczyną	Pszczyna	subst:sg:inst:f	nazwa geograficzna	
> Pszczynę	Pszczyna	subst:sg:acc:f	nazwa geograficzna	
> Pszczynie	Pszczyna	subst:sg:dat.loc:f	nazwa geograficzna	
> Pszczynom	Pszczyna	subst:pl:dat:f	nazwa geograficzna	
> Pszczyno	Pszczyna	subst:sg:voc:f	nazwa geograficzna	
> Pszczyn	Pszczyna	subst:pl:gen:f	nazwa geograficzna	
> Pszczyny	Pszczyna	subst:pl:nom.acc.voc:f	nazwa geograficzna	
> Pszczyny	Pszczyna	subst:sg:gen:f	nazwa geograficzna	
4835710a4836728,4836750
> radzynianach	radzynianin	subst:pl:loc:m1	nazwa pospolita	
> radzynianami	radzynianin	subst:pl:inst:m1	nazwa pospolita	
> radzynianie	radzynianin	subst:pl:nom.voc:m1	nazwa pospolita	
> radzynianina	radzynianin	subst:sg:gen.acc:m1	nazwa pospolita	
> radzynianinem	radzynianin	subst:sg:inst:m1	nazwa pospolita	
> radzynianinie	radzynianin	subst:sg:loc:m1	nazwa pospolita	
> radzynianinie	radzynianin	subst:sg:voc:m1	nazwa pospolita	
> radzynianinowi	radzynianin	subst:sg:dat:m1	nazwa pospolita	
> radzynianin	radzynianin	subst:sg:nom:m1	nazwa pospolita	
> radzynianom	radzynianin	subst:pl:dat:m1	nazwa pospolita	
> radzynian	radzynianin	subst:pl:gen.acc:m1	nazwa pospolita	
> radzyniany	radzynianin	depr:pl:nom.acc.voc:m2	nazwa pospolita	
> radzyniance	radzynianka	subst:sg:dat.loc:f	nazwa pospolita	
> radzynianek	radzynianka	subst:pl:gen:f	nazwa pospolita	
> radzyniankach	radzynianka	subst:pl:loc:f	nazwa pospolita	
> radzyniankami	radzynianka	subst:pl:inst:f	nazwa pospolita	
> radzynianka	radzynianka	subst:sg:nom:f	nazwa pospolita	
> radzynianką	radzynianka	subst:sg:inst:f	nazwa pospolita	
> radzyniankę	radzynianka	subst:sg:acc:f	nazwa pospolita	
> radzynianki	radzynianka	subst:pl:nom.acc.voc:f	nazwa pospolita	
> radzynianki	radzynianka	subst:sg:gen:f	nazwa pospolita	
> radzyniankom	radzynianka	subst:pl:dat:f	nazwa pospolita	
> radzynianko	radzynianka	subst:sg:voc:f	nazwa pospolita	
4848021a4849062,4849084
> rawianach	rawianin	subst:pl:loc:m1	nazwa pospolita	
> rawianami	rawianin	subst:pl:inst:m1	nazwa pospolita	
> rawianie	rawianin	subst:pl:nom.voc:m1	nazwa pospolita	
> rawianina	rawianin	subst:sg:gen.acc:m1	nazwa pospolita	
> rawianinem	rawianin	subst:sg:inst:m1	nazwa pospolita	
> rawianinie	rawianin	subst:sg:loc:m1	nazwa pospolita	
> rawianinie	rawianin	subst:sg:voc:m1	nazwa pospolita	
> rawianinowi	rawianin	subst:sg:dat:m1	nazwa pospolita	
> rawianin	rawianin	subst:sg:nom:m1	nazwa pospolita	
> rawianom	rawianin	subst:pl:dat:m1	nazwa pospolita	
> rawian	rawianin	subst:pl:gen.acc:m1	nazwa pospolita	
> rawiany	rawianin	depr:pl:nom.acc.voc:m2	nazwa pospolita	
> rawiance	rawianka	subst:sg:dat.loc:f	nazwa pospolita	
> rawianek	rawianka	subst:pl:gen:f	nazwa pospolita	
> rawiankach	rawianka	subst:pl:loc:f	nazwa pospolita	
> rawiankami	rawianka	subst:pl:inst:f	nazwa pospolita	
> rawianka	rawianka	subst:sg:nom:f	nazwa pospolita	
> rawianką	rawianka	subst:sg:inst:f	nazwa pospolita	
> rawiankę	rawianka	subst:sg:acc:f	nazwa pospolita	
> rawianki	rawianka	subst:pl:nom.acc.voc:f	nazwa pospolita	
> rawianki	rawianka	subst:sg:gen:f	nazwa pospolita	
> rawiankom	rawianka	subst:pl:dat:f	nazwa pospolita	
> rawianko	rawianka	subst:sg:voc:f	nazwa pospolita	
4909976a4911040,4911050
> Romce	Romka	subst:sg:dat.loc:f	nazwa pospolita	etn.
> Romek	Romka	subst:pl:gen:f	nazwa pospolita	etn.
> Romkach	Romka	subst:pl:loc:f	nazwa pospolita	etn.
> Romkami	Romka	subst:pl:inst:f	nazwa pospolita	etn.
> Romka	Romka	subst:sg:nom:f	nazwa pospolita	etn.
> Romką	Romka	subst:sg:inst:f	nazwa pospolita	etn.
> Romkę	Romka	subst:sg:acc:f	nazwa pospolita	etn.
> Romki	Romka	subst:pl:nom.acc.voc:f	nazwa pospolita	etn.
> Romki	Romka	subst:sg:gen:f	nazwa pospolita	etn.
> Romkom	Romka	subst:pl:dat:f	nazwa pospolita	etn.
> Romko	Romka	subst:sg:voc:f	nazwa pospolita	etn.
5117742a5118817,5118839
> rudzianach	rudzianin	subst:pl:loc:m1	nazwa pospolita	
> rudzianami	rudzianin	subst:pl:inst:m1	nazwa pospolita	
> rudzianie	rudzianin	subst:pl:nom.voc:m1	nazwa pospolita	
> rudzianina	rudzianin	subst:sg:gen.acc:m1	nazwa pospolita	
> rudzianinem	rudzianin	subst:sg:inst:m1	nazwa pospolita	
> rudzianinie	rudzianin	subst:sg:loc:m1	nazwa pospolita	
> rudzianinie	rudzianin	subst:sg:voc:m1	nazwa pospolita	
> rudzianinowi	rudzianin	subst:sg:dat:m1	nazwa pospolita	
> rudzianin	rudzianin	subst:sg:nom:m1	nazwa pospolita	
> rudzianom	rudzianin	subst:pl:dat:m1	nazwa pospolita	
> rudzian	rudzianin	subst:pl:gen.acc:m1	nazwa pospolita	
> rudziany	rudzianin	depr:pl:nom.acc.voc:m2	nazwa pospolita	
> rudziance	rudzianka	subst:sg:dat.loc:f	nazwa pospolita	
> rudzianek	rudzianka	subst:pl:gen:f	nazwa pospolita	
> rudziankach	rudzianka	subst:pl:loc:f	nazwa pospolita	
> rudziankami	rudzianka	subst:pl:inst:f	nazwa pospolita	
> rudzianka	rudzianka	subst:sg:nom:f	nazwa pospolita	
> rudzianką	rudzianka	subst:sg:inst:f	nazwa pospolita	
> rudziankę	rudzianka	subst:sg:acc:f	nazwa pospolita	
> rudzianki	rudzianka	subst:pl:nom.acc.voc:f	nazwa pospolita	
> rudzianki	rudzianka	subst:sg:gen:f	nazwa pospolita	
> rudziankom	rudzianka	subst:pl:dat:f	nazwa pospolita	
> rudzianko	rudzianka	subst:sg:voc:f	nazwa pospolita	
5124531a5125629,5125639
> Rusince	Rusinka	subst:sg:dat.loc:f	nazwa pospolita	etn.
> Rusinek	Rusinka	subst:pl:gen:f	nazwa pospolita	etn.
> Rusinkach	Rusinka	subst:pl:loc:f	nazwa pospolita	etn.
> Rusinkami	Rusinka	subst:pl:inst:f	nazwa pospolita	etn.
> Rusinka	Rusinka	subst:sg:nom:f	nazwa pospolita	etn.
> Rusinką	Rusinka	subst:sg:inst:f	nazwa pospolita	etn.
> Rusinkę	Rusinka	subst:sg:acc:f	nazwa pospolita	etn.
> Rusinki	Rusinka	subst:pl:nom.acc.voc:f	nazwa pospolita	etn.
> Rusinki	Rusinka	subst:sg:gen:f	nazwa pospolita	etn.
> Rusinkom	Rusinka	subst:pl:dat:f	nazwa pospolita	etn.
> Rusinko	Rusinka	subst:sg:voc:f	nazwa pospolita	etn.
5124740a5125849,5125859
> Rusce	Ruska	subst:sg:dat.loc:f	nazwa pospolita	pot.
> Rusek	Ruska	subst:pl:gen:f	nazwa pospolita	pot.
> Ruskach	Ruska	subst:pl:loc:f	nazwa pospolita	pot.
> Ruskami	Ruska	subst:pl:inst:f	nazwa pospolita	pot.
> Ruska	Ruska	subst:sg:nom:f	nazwa pospolita	pot.
> Ruską	Ruska	subst:sg:inst:f	nazwa pospolita	pot.
> Ruskę	Ruska	subst:sg:acc:f	nazwa pospolita	pot.
> Ruski	Ruska	subst:pl:nom.acc.voc:f	nazwa pospolita	pot.
> Ruski	Ruska	subst:sg:gen:f	nazwa pospolita	pot.
> Ruskom	Ruska	subst:pl:dat:f	nazwa pospolita	pot.
> Rusko	Ruska	subst:sg:voc:f	nazwa pospolita	pot.
5138407a5139527,5139537
> Rypinach	Rypin	subst:pl:loc:m3	nazwa geograficzna	
> Rypinami	Rypin	subst:pl:inst:m3	nazwa geograficzna	
> Rypina	Rypin	subst:sg:gen:m3	nazwa geograficzna	
> Rypinem	Rypin	subst:sg:inst:m3	nazwa geograficzna	
> Rypinie	Rypin	subst:sg:loc:m3	nazwa geograficzna	
> Rypinie	Rypin	subst:sg:voc:m3	nazwa geograficzna	
> Rypinom	Rypin	subst:pl:dat:m3	nazwa geograficzna	
> Rypinowi	Rypin	subst:sg:dat:m3	nazwa geograficzna	
> Rypinów	Rypin	subst:pl:gen:m3	nazwa geograficzna	
> Rypin	Rypin	subst:sg:nom.acc:m3	nazwa geograficzna	
> Rypiny	Rypin	subst:pl:nom.acc.voc:m3	nazwa geograficzna	
5138430a5139561,5139583
> rypinianach	rypinianin	subst:pl:loc:m1	nazwa pospolita	
> rypinianami	rypinianin	subst:pl:inst:m1	nazwa pospolita	
> rypinianie	rypinianin	subst:pl:nom.voc:m1	nazwa pospolita	
> rypinianina	rypinianin	subst:sg:gen.acc:m1	nazwa pospolita	
> rypinianinem	rypinianin	subst:sg:inst:m1	nazwa pospolita	
> rypinianinie	rypinianin	subst:sg:loc:m1	nazwa pospolita	
> rypinianinie	rypinianin	subst:sg:voc:m1	nazwa pospolita	
> rypinianinowi	rypinianin	subst:sg:dat:m1	nazwa pospolita	
> rypinianin	rypinianin	subst:sg:nom:m1	nazwa pospolita	
> rypinianom	rypinianin	subst:pl:dat:m1	nazwa pospolita	
> rypinian	rypinianin	subst:pl:gen.acc:m1	nazwa pospolita	
> rypiniany	rypinianin	depr:pl:nom.acc.voc:m2	nazwa pospolita	
> rypiniance	rypinianka	subst:sg:dat.loc:f	nazwa pospolita	
> rypinianek	rypinianka	subst:pl:gen:f	nazwa pospolita	
> rypiniankach	rypinianka	subst:pl:loc:f	nazwa pospolita	
> rypiniankami	rypinianka	subst:pl:inst:f	nazwa pospolita	
> rypinianka	rypinianka	subst:sg:nom:f	nazwa pospolita	
> rypinianką	rypinianka	subst:sg:inst:f	nazwa pospolita	
> rypiniankę	rypinianka	subst:sg:acc:f	nazwa pospolita	
> rypinianki	rypinianka	subst:pl:nom.acc.voc:f	nazwa pospolita	
> rypinianki	rypinianka	subst:sg:gen:f	nazwa pospolita	
> rypiniankom	rypinianka	subst:pl:dat:f	nazwa pospolita	
> rypinianko	rypinianka	subst:sg:voc:f	nazwa pospolita	
5181574a5182728,5182738
> sanoczance	sanoczanka	subst:sg:dat.loc:f	nazwa pospolita	
> sanoczanek	sanoczanka	subst:pl:gen:f	nazwa pospolita	
> sanoczankach	sanoczanka	subst:pl:loc:f	nazwa pospolita	
> sanoczankami	sanoczanka	subst:pl:inst:f	nazwa pospolita	
> sanoczanka	sanoczanka	subst:sg:nom:f	nazwa pospolita	
> sanoczanką	sanoczanka	subst:sg:inst:f	nazwa pospolita	
> sanoczankę	sanoczanka	subst:sg:acc:f	nazwa pospolita	
> sanoczanki	sanoczanka	subst:pl:nom.acc.voc:f	nazwa pospolita	
> sanoczanki	sanoczanka	subst:sg:gen:f	nazwa pospolita	
> sanoczankom	sanoczanka	subst:pl:dat:f	nazwa pospolita	
> sanoczanko	sanoczanka	subst:sg:voc:f	nazwa pospolita	
5363108a5364273,5364295
> sokołowianach	sokołowianin	subst:pl:loc:m1	nazwa pospolita	
> sokołowianami	sokołowianin	subst:pl:inst:m1	nazwa pospolita	
> sokołowianie	sokołowianin	subst:pl:nom.voc:m1	nazwa pospolita	
> sokołowianina	sokołowianin	subst:sg:gen.acc:m1	nazwa pospolita	
> sokołowianinem	sokołowianin	subst:sg:inst:m1	nazwa pospolita	
> sokołowianinie	sokołowianin	subst:sg:loc:m1	nazwa pospolita	
> sokołowianinie	sokołowianin	subst:sg:voc:m1	nazwa pospolita	
> sokołowianinowi	sokołowianin	subst:sg:dat:m1	nazwa pospolita	
> sokołowianin	sokołowianin	subst:sg:nom:m1	nazwa pospolita	
> sokołowianom	sokołowianin	subst:pl:dat:m1	nazwa pospolita	
> sokołowian	sokołowianin	subst:pl:gen.acc:m1	nazwa pospolita	
> sokołowiany	sokołowianin	depr:pl:nom.acc.voc:m2	nazwa pospolita	
> sokołowiance	sokołowianka	subst:sg:dat.loc:f	nazwa pospolita	
> sokołowianek	sokołowianka	subst:pl:gen:f	nazwa pospolita	
> sokołowiankach	sokołowianka	subst:pl:loc:f	nazwa pospolita	
> sokołowiankami	sokołowianka	subst:pl:inst:f	nazwa pospolita	
> sokołowianka	sokołowianka	subst:sg:nom:f	nazwa pospolita	
> sokołowianką	sokołowianka	subst:sg:inst:f	nazwa pospolita	
> sokołowiankę	sokołowianka	subst:sg:acc:f	nazwa pospolita	
> sokołowianki	sokołowianka	subst:pl:nom.acc.voc:f	nazwa pospolita	
> sokołowianki	sokołowianka	subst:sg:gen:f	nazwa pospolita	
> sokołowiankom	sokołowianka	subst:pl:dat:f	nazwa pospolita	
> sokołowianko	sokołowianka	subst:sg:voc:f	nazwa pospolita	
5372338a5373526,5373536
> sosnowiczance	sosnowiczanka	subst:sg:dat.loc:f	nazwa pospolita	
> sosnowiczanek	sosnowiczanka	subst:pl:gen:f	nazwa pospolita	
> sosnowiczankach	sosnowiczanka	subst:pl:loc:f	nazwa pospolita	
> sosnowiczankami	sosnowiczanka	subst:pl:inst:f	nazwa pospolita	
> sosnowiczanka	sosnowiczanka	subst:sg:nom:f	nazwa pospolita	
> sosnowiczanką	sosnowiczanka	subst:sg:inst:f	nazwa pospolita	
> sosnowiczankę	sosnowiczanka	subst:sg:acc:f	nazwa pospolita	
> sosnowiczanki	sosnowiczanka	subst:pl:nom.acc.voc:f	nazwa pospolita	
> sosnowiczanki	sosnowiczanka	subst:sg:gen:f	nazwa pospolita	
> sosnowiczankom	sosnowiczanka	subst:pl:dat:f	nazwa pospolita	
> sosnowiczanko	sosnowiczanka	subst:sg:voc:f	nazwa pospolita	
5506732a5507931,5507953
> strzelczanach	strzelczanin	subst:pl:loc:m1	nazwa pospolita	
> strzelczanami	strzelczanin	subst:pl:inst:m1	nazwa pospolita	
> strzelczanie	strzelczanin	subst:pl:nom.voc:m1	nazwa pospolita	
> strzelczanina	strzelczanin	subst:sg:gen.acc:m1	nazwa pospolita	
> strzelczaninem	strzelczanin	subst:sg:inst:m1	nazwa pospolita	
> strzelczaninie	strzelczanin	subst:sg:loc:m1	nazwa pospolita	
> strzelczaninie	strzelczanin	subst:sg:voc:m1	nazwa pospolita	
> strzelczaninowi	strzelczanin	subst:sg:dat:m1	nazwa pospolita	
> strzelczanin	strzelczanin	subst:sg:nom:m1	nazwa pospolita	
> strzelczanom	strzelczanin	subst:pl:dat:m1	nazwa pospolita	
> strzelczan	strzelczanin	subst:pl:gen.acc:m1	nazwa pospolita	
> strzelczany	strzelczanin	depr:pl:nom.acc.voc:m2	nazwa pospolita	
> strzelczance	strzelczanka	subst:sg:dat.loc:f	nazwa pospolita	
> strzelczanek	strzelczanka	subst:pl:gen:f	nazwa pospolita	
> strzelczankach	strzelczanka	subst:pl:loc:f	nazwa pospolita	
> strzelczankami	strzelczanka	subst:pl:inst:f	nazwa pospolita	
> strzelczanka	strzelczanka	subst:sg:nom:f	nazwa pospolita	
> strzelczanką	strzelczanka	subst:sg:inst:f	nazwa pospolita	
> strzelczankę	strzelczanka	subst:sg:acc:f	nazwa pospolita	
> strzelczanki	strzelczanka	subst:pl:nom.acc.voc:f	nazwa pospolita	
> strzelczanki	strzelczanka	subst:sg:gen:f	nazwa pospolita	
> strzelczankom	strzelczanka	subst:pl:dat:f	nazwa pospolita	
> strzelczanko	strzelczanka	subst:sg:voc:f	nazwa pospolita	
5507082a5508304,5508337
> Strzelinach	Strzelin	subst:pl:loc:m3	nazwa geograficzna	
> Strzelinami	Strzelin	subst:pl:inst:m3	nazwa geograficzna	
> Strzelina	Strzelin	subst:sg:gen:m3	nazwa geograficzna	
> Strzelinem	Strzelin	subst:sg:inst:m3	nazwa geograficzna	
> Strzelinie	Strzelin	subst:sg:loc:m3	nazwa geograficzna	
> Strzelinie	Strzelin	subst:sg:voc:m3	nazwa geograficzna	
> Strzelinom	Strzelin	subst:pl:dat:m3	nazwa geograficzna	
> Strzelinowi	Strzelin	subst:sg:dat:m3	nazwa geograficzna	
> Strzelinów	Strzelin	subst:pl:gen:m3	nazwa geograficzna	
> Strzelin	Strzelin	subst:sg:nom.acc:m3	nazwa geograficzna	
> Strzeliny	Strzelin	subst:pl:nom.acc.voc:m3	nazwa geograficzna	
> strzelinianach	strzelinianin	subst:pl:loc:m1	nazwa pospolita	
> strzelinianami	strzelinianin	subst:pl:inst:m1	nazwa pospolita	
> strzelinianie	strzelinianin	subst:pl:nom.voc:m1	nazwa pospolita	
> strzelinianina	strzelinianin	subst:sg:gen.acc:m1	nazwa pospolita	
> strzelinianinem	strzelinianin	subst:sg:inst:m1	nazwa pospolita	
> strzelinianinie	strzelinianin	subst:sg:loc:m1	nazwa pospolita	
> strzelinianinie	strzelinianin	subst:sg:voc:m1	nazwa pospolita	
> strzelinianinowi	strzelinianin	subst:sg:dat:m1	nazwa pospolita	
> strzelinianin	strzelinianin	subst:sg:nom:m1	nazwa pospolita	
> strzelinianom	strzelinianin	subst:pl:dat:m1	nazwa pospolita	
> strzelinian	strzelinianin	subst:pl:gen.acc:m1	nazwa pospolita	
> strzeliniany	strzelinianin	depr:pl:nom.acc.voc:m2	nazwa pospolita	
> strzeliniance	strzelinianka	subst:sg:dat.loc:f	nazwa pospolita	
> strzelinianek	strzelinianka	subst:pl:gen:f	nazwa pospolita	
> strzeliniankach	strzelinianka	subst:pl:loc:f	nazwa pospolita	
> strzeliniankami	strzelinianka	subst:pl:inst:f	nazwa pospolita	
> strzelinianka	strzelinianka	subst:sg:nom:f	nazwa pospolita	
> strzelinianką	strzelinianka	subst:sg:inst:f	nazwa pospolita	
> strzeliniankę	strzelinianka	subst:sg:acc:f	nazwa pospolita	
> strzelinianki	strzelinianka	subst:pl:nom.acc.voc:f	nazwa pospolita	
> strzelinianki	strzelinianka	subst:sg:gen:f	nazwa pospolita	
> strzeliniankom	strzelinianka	subst:pl:dat:f	nazwa pospolita	
> strzelinianko	strzelinianka	subst:sg:voc:f	nazwa pospolita	
5680753a5682009,5682042
> Śremach	Śrem	subst:pl:loc:m3	nazwa geograficzna	
> Śremami	Śrem	subst:pl:inst:m3	nazwa geograficzna	
> Śremem	Śrem	subst:sg:inst:m3	nazwa geograficzna	
> Śremie	Śrem	subst:sg:loc:m3	nazwa geograficzna	
> Śremie	Śrem	subst:sg:voc:m3	nazwa geograficzna	
> Śremom	Śrem	subst:pl:dat:m3	nazwa geograficzna	
> Śremowi	Śrem	subst:sg:dat:m3	nazwa geograficzna	
> Śremów	Śrem	subst:pl:gen:m3	nazwa geograficzna	
> Śrem	Śrem	subst:sg:nom.acc:m3	nazwa geograficzna	
> Śremu	Śrem	subst:sg:gen:m3	nazwa geograficzna	
> Śremy	Śrem	subst:pl:nom.acc.voc:m3	nazwa geograficzna	
> śremianach	śremianin	subst:pl:loc:m1	nazwa pospolita	
> śremianami	śremianin	subst:pl:inst:m1	nazwa pospolita	
> śremianie	śremianin	subst:pl:nom.voc:m1	nazwa pospolita	
> śremianina	śremianin	subst:sg:gen.acc:m1	nazwa pospolita	
> śremianinem	śremianin	subst:sg:inst:m1	nazwa pospolita	
> śremianinie	śremianin	subst:sg:loc:m1	nazwa pospolita	
> śremianinie	śremianin	subst:sg:voc:m1	nazwa pospolita	
> śremianinowi	śremianin	subst:sg:dat:m1	nazwa pospolita	
> śremianin	śremianin	subst:sg:nom:m1	nazwa pospolita	
> śremianom	śremianin	subst:pl:dat:m1	nazwa pospolita	
> śremian	śremianin	subst:pl:gen.acc:m1	nazwa pospolita	
> śremiany	śremianin	depr:pl:nom.acc.voc:m2	nazwa pospolita	
> śremiance	śremianka	subst:sg:dat.loc:f	nazwa pospolita	
> śremianek	śremianka	subst:pl:gen:f	nazwa pospolita	
> śremiankach	śremianka	subst:pl:loc:f	nazwa pospolita	
> śremiankami	śremianka	subst:pl:inst:f	nazwa pospolita	
> śremianka	śremianka	subst:sg:nom:f	nazwa pospolita	
> śremianką	śremianka	subst:sg:inst:f	nazwa pospolita	
> śremiankę	śremianka	subst:sg:acc:f	nazwa pospolita	
> śremianki	śremianka	subst:pl:nom.acc.voc:f	nazwa pospolita	
> śremianki	śremianka	subst:sg:gen:f	nazwa pospolita	
> śremiankom	śremianka	subst:pl:dat:f	nazwa pospolita	
> śremianko	śremianka	subst:sg:voc:f	nazwa pospolita	
5687391a5688681,5688703
> Świdwinach	Świdwin	subst:pl:loc:m3	nazwa geograficzna	
> Świdwinami	Świdwin	subst:pl:inst:m3	nazwa geograficzna	
> Świdwina	Świdwin	subst:sg:gen:m3	nazwa geograficzna	
> Świdwinem	Świdwin	subst:sg:inst:m3	nazwa geograficzna	
> Świdwinie	Świdwin	subst:sg:loc:m3	nazwa geograficzna	
> Świdwinie	Świdwin	subst:sg:voc:m3	nazwa geograficzna	
> Świdwinom	Świdwin	subst:pl:dat:m3	nazwa geograficzna	
> Świdwinowi	Świdwin	subst:sg:dat:m3	nazwa geograficzna	
> Świdwinów	Świdwin	subst:pl:gen:m3	nazwa geograficzna	
> Świdwin	Świdwin	subst:sg:nom.acc:m3	nazwa geograficzna	
> Świdwiny	Świdwin	subst:pl:nom.acc.voc:m3	nazwa geograficzna	
> świdwinianach	świdwinianin	subst:pl:loc:m1	nazwa pospolita	
> świdwinianami	świdwinianin	subst:pl:inst:m1	nazwa pospolita	
> świdwinianie	świdwinianin	subst:pl:nom.voc:m1	nazwa pospolita	
> świdwinianina	świdwinianin	subst:sg:gen.acc:m1	nazwa pospolita	
> świdwinianinem	świdwinianin	subst:sg:inst:m1	nazwa pospolita	
> świdwinianinie	świdwinianin	subst:sg:loc:m1	nazwa pospolita	
> świdwinianinie	świdwinianin	subst:sg:voc:m1	nazwa pospolita	
> świdwinianinowi	świdwinianin	subst:sg:dat:m1	nazwa pospolita	
> świdwinianin	świdwinianin	subst:sg:nom:m1	nazwa pospolita	
> świdwinianom	świdwinianin	subst:pl:dat:m1	nazwa pospolita	
> świdwinian	świdwinianin	subst:pl:gen.acc:m1	nazwa pospolita	
> świdwiniany	świdwinianin	depr:pl:nom.acc.voc:m2	nazwa pospolita	
5687555a5688868,5688901
> Świebodzinach	Świebodzin	subst:pl:loc:m3	nazwa geograficzna	
> Świebodzinami	Świebodzin	subst:pl:inst:m3	nazwa geograficzna	
> Świebodzina	Świebodzin	subst:sg:gen:m3	nazwa geograficzna	
> Świebodzinem	Świebodzin	subst:sg:inst:m3	nazwa geograficzna	
> Świebodzinie	Świebodzin	subst:sg:loc:m3	nazwa geograficzna	
> Świebodzinie	Świebodzin	subst:sg:voc:m3	nazwa geograficzna	
> Świebodzinom	Świebodzin	subst:pl:dat:m3	nazwa geograficzna	
> Świebodzinowi	Świebodzin	subst:sg:dat:m3	nazwa geograficzna	
> Świebodzinów	Świebodzin	subst:pl:gen:m3	nazwa geograficzna	
> Świebodzin	Świebodzin	subst:sg:nom.acc:m3	nazwa geograficzna	
> Świebodziny	Świebodzin	subst:pl:nom.acc.voc:m3	nazwa geograficzna	
> świebodzinianach	świebodzinianin	subst:pl:loc:m1	nazwa pospolita	
> świebodzinianami	świebodzinianin	subst:pl:inst:m1	nazwa pospolita	
> świebodzinianie	świebodzinianin	subst:pl:nom.voc:m1	nazwa pospolita	
> świebodzinianina	świebodzinianin	subst:sg:gen.acc:m1	nazwa pospolita	
> świebodzinianinem	świebodzinianin	subst:sg:inst:m1	nazwa pospolita	
> świebodzinianinie	świebodzinianin	subst:sg:loc:m1	nazwa pospolita	
> świebodzinianinie	świebodzinianin	subst:sg:voc:m1	nazwa pospolita	
> świebodzinianinowi	świebodzinianin	subst:sg:dat:m1	nazwa pospolita	
> świebodzinianin	świebodzinianin	subst:sg:nom:m1	nazwa pospolita	
> świebodzinianom	świebodzinianin	subst:pl:dat:m1	nazwa pospolita	
> świebodzinian	świebodzinianin	subst:pl:gen.acc:m1	nazwa pospolita	
> świebodziniany	świebodzinianin	depr:pl:nom.acc.voc:m2	nazwa pospolita	
> świebodziniance	świebodzinianka	subst:sg:dat.loc:f	nazwa pospolita	
> świebodzinianek	świebodzinianka	subst:pl:gen:f	nazwa pospolita	
> świebodziniankach	świebodzinianka	subst:pl:loc:f	nazwa pospolita	
> świebodziniankami	świebodzinianka	subst:pl:inst:f	nazwa pospolita	
> świebodzinianka	świebodzinianka	subst:sg:nom:f	nazwa pospolita	
> świebodzinianką	świebodzinianka	subst:sg:inst:f	nazwa pospolita	
> świebodziniankę	świebodzinianka	subst:sg:acc:f	nazwa pospolita	
> świebodzinianki	świebodzinianka	subst:pl:nom.acc.voc:f	nazwa pospolita	
> świebodzinianki	świebodzinianka	subst:sg:gen:f	nazwa pospolita	
> świebodziniankom	świebodzinianka	subst:pl:dat:f	nazwa pospolita	
> świebodzinianko	świebodzinianka	subst:sg:voc:f	nazwa pospolita	
6105716a6107063,6107095
> wąbrzeźnianach	wąbrzeźnianin	subst:pl:loc:m1	nazwa pospolita	
> wąbrzeźnianami	wąbrzeźnianin	subst:pl:inst:m1	nazwa pospolita	
> wąbrzeźnianie	wąbrzeźnianin	subst:pl:nom.voc:m1	nazwa pospolita	
> wąbrzeźnianina	wąbrzeźnianin	subst:sg:gen.acc:m1	nazwa pospolita	
> wąbrzeźnianinem	wąbrzeźnianin	subst:sg:inst:m1	nazwa pospolita	
> wąbrzeźnianinie	wąbrzeźnianin	subst:sg:loc:m1	nazwa pospolita	
> wąbrzeźnianinie	wąbrzeźnianin	subst:sg:voc:m1	nazwa pospolita	
> wąbrzeźnianinowi	wąbrzeźnianin	subst:sg:dat:m1	nazwa pospolita	
> wąbrzeźnianin	wąbrzeźnianin	subst:sg:nom:m1	nazwa pospolita	
> wąbrzeźnianom	wąbrzeźnianin	subst:pl:dat:m1	nazwa pospolita	
> wąbrzeźnian	wąbrzeźnianin	subst:pl:gen.acc:m1	nazwa pospolita	
> wąbrzeźniany	wąbrzeźnianin	depr:pl:nom.acc.voc:m2	nazwa pospolita	
> wąbrzeźniance	wąbrzeźnianka	subst:sg:dat.loc:f	nazwa pospolita	
> wąbrzeźnianek	wąbrzeźnianka	subst:pl:gen:f	nazwa pospolita	
> wąbrzeźniankach	wąbrzeźnianka	subst:pl:loc:f	nazwa pospolita	
> wąbrzeźniankami	wąbrzeźnianka	subst:pl:inst:f	nazwa pospolita	
> wąbrzeźnianka	wąbrzeźnianka	subst:sg:nom:f	nazwa pospolita	
> wąbrzeźnianką	wąbrzeźnianka	subst:sg:inst:f	nazwa pospolita	
> wąbrzeźniankę	wąbrzeźnianka	subst:sg:acc:f	nazwa pospolita	
> wąbrzeźnianki	wąbrzeźnianka	subst:pl:nom.acc.voc:f	nazwa pospolita	
> wąbrzeźnianki	wąbrzeźnianka	subst:sg:gen:f	nazwa pospolita	
> wąbrzeźniankom	wąbrzeźnianka	subst:pl:dat:f	nazwa pospolita	
> wąbrzeźnianko	wąbrzeźnianka	subst:sg:voc:f	nazwa pospolita	
> Wąbrzeźnach	Wąbrzeźno	subst:pl:loc:n:ncol	nazwa geograficzna	
> Wąbrzeźnami	Wąbrzeźno	subst:pl:inst:n:ncol	nazwa geograficzna	
> Wąbrzeźna	Wąbrzeźno	subst:pl:nom.acc.voc:n:ncol	nazwa geograficzna	
> Wąbrzeźna	Wąbrzeźno	subst:sg:gen:n:ncol	nazwa geograficzna	
> Wąbrzeźnem	Wąbrzeźno	subst:sg:inst:n:ncol	nazwa geograficzna	
> Wąbrzeźnie	Wąbrzeźno	subst:sg:loc:n:ncol	nazwa geograficzna	
> Wąbrzeźnom	Wąbrzeźno	subst:pl:dat:n:ncol	nazwa geograficzna	
> Wąbrzeźno	Wąbrzeźno	subst:sg:nom.acc.voc:n:ncol	nazwa geograficzna	
> Wąbrzeźnu	Wąbrzeźno	subst:sg:dat:n:ncol	nazwa geograficzna	
> Wąbrzeźn	Wąbrzeźno	subst:pl:gen:n:ncol	nazwa geograficzna	
6128411a6129791,6129801
> Wenusjance	Wenusjanka	subst:sg:dat.loc:f	nazwa pospolita	
> Wenusjanek	Wenusjanka	subst:pl:gen:f	nazwa pospolita	
> Wenusjankach	Wenusjanka	subst:pl:loc:f	nazwa pospolita	
> Wenusjankami	Wenusjanka	subst:pl:inst:f	nazwa pospolita	
> Wenusjanka	Wenusjanka	subst:sg:nom:f	nazwa pospolita	
> Wenusjanką	Wenusjanka	subst:sg:inst:f	nazwa pospolita	
> Wenusjankę	Wenusjanka	subst:sg:acc:f	nazwa pospolita	
> Wenusjanki	Wenusjanka	subst:pl:nom.acc.voc:f	nazwa pospolita	
> Wenusjanki	Wenusjanka	subst:sg:gen:f	nazwa pospolita	
> Wenusjankom	Wenusjanka	subst:pl:dat:f	nazwa pospolita	
> Wenusjanko	Wenusjanka	subst:sg:voc:f	nazwa pospolita	
6198004a6199395,6199406
> wiślanach	wiślanin	subst:pl:loc:m1	nazwa pospolita	
> wiślanami	wiślanin	subst:pl:inst:m1	nazwa pospolita	
> wiślanie	wiślanin	subst:pl:nom.voc:m1	nazwa pospolita	
> wiślanina	wiślanin	subst:sg:gen.acc:m1	nazwa pospolita	
> wiślaninem	wiślanin	subst:sg:inst:m1	nazwa pospolita	
> wiślaninie	wiślanin	subst:sg:loc:m1	nazwa pospolita	
> wiślaninie	wiślanin	subst:sg:voc:m1	nazwa pospolita	
> wiślaninowi	wiślanin	subst:sg:dat:m1	nazwa pospolita	
> wiślanin	wiślanin	subst:sg:nom:m1	nazwa pospolita	
> wiślanom	wiślanin	subst:pl:dat:m1	nazwa pospolita	
> wiślan	wiślanin	subst:pl:gen.acc:m1	nazwa pospolita	
> wiślany	wiślanin	depr:pl:nom.acc.voc:m2	nazwa pospolita	
6216966a6218369,6218402
> Włodawach	Włodawa	subst:pl:loc:f	nazwa geograficzna	
> Włodawami	Włodawa	subst:pl:inst:f	nazwa geograficzna	
> Włodawa	Włodawa	subst:sg:nom:f	nazwa geograficzna	
> Włodawą	Włodawa	subst:sg:inst:f	nazwa geograficzna	
> Włodawę	Włodawa	subst:sg:acc:f	nazwa geograficzna	
> Włodawie	Włodawa	subst:sg:dat.loc:f	nazwa geograficzna	
> Włodawom	Włodawa	subst:pl:dat:f	nazwa geograficzna	
> Włodawo	Włodawa	subst:sg:voc:f	nazwa geograficzna	
> Włodaw	Włodawa	subst:pl:gen:f	nazwa geograficzna	
> Włodawy	Włodawa	subst:pl:nom.acc.voc:f	nazwa geograficzna	
> Włodawy	Włodawa	subst:sg:gen:f	nazwa geograficzna	
> włodawianach	włodawianin	subst:pl:loc:m1	nazwa pospolita	
> włodawianami	włodawianin	subst:pl:inst:m1	nazwa pospolita	
> włodawianie	włodawianin	subst:pl:nom.voc:m1	nazwa pospolita	
> włodawianina	włodawianin	subst:sg:gen.acc:m1	nazwa pospolita	
> włodawianinem	włodawianin	subst:sg:inst:m1	nazwa pospolita	
> włodawianinie	włodawianin	subst:sg:loc:m1	nazwa pospolita	
> włodawianinie	włodawianin	subst:sg:voc:m1	nazwa pospolita	
> włodawianinowi	włodawianin	subst:sg:dat:m1	nazwa pospolita	
> włodawianin	włodawianin	subst:sg:nom:m1	nazwa pospolita	
> włodawianom	włodawianin	subst:pl:dat:m1	nazwa pospolita	
> włodawian	włodawianin	subst:pl:gen.acc:m1	nazwa pospolita	
> włodawiany	włodawianin	depr:pl:nom.acc.voc:m2	nazwa pospolita	
> włodawiance	włodawianka	subst:sg:dat.loc:f	nazwa pospolita	
> włodawianek	włodawianka	subst:pl:gen:f	nazwa pospolita	
> włodawiankach	włodawianka	subst:pl:loc:f	nazwa pospolita	
> włodawiankami	włodawianka	subst:pl:inst:f	nazwa pospolita	
> włodawianka	włodawianka	subst:sg:nom:f	nazwa pospolita	
> włodawianką	włodawianka	subst:sg:inst:f	nazwa pospolita	
> włodawiankę	włodawianka	subst:sg:acc:f	nazwa pospolita	
> włodawianki	włodawianka	subst:pl:nom.acc.voc:f	nazwa pospolita	
> włodawianki	włodawianka	subst:sg:gen:f	nazwa pospolita	
> włodawiankom	włodawianka	subst:pl:dat:f	nazwa pospolita	
> włodawianko	włodawianka	subst:sg:voc:f	nazwa pospolita	
6273426a6274863,6274896
> Wschowach	Wschowa	subst:pl:loc:f	nazwa geograficzna	
> Wschowami	Wschowa	subst:pl:inst:f	nazwa geograficzna	
> Wschowa	Wschowa	subst:sg:nom:f	nazwa geograficzna	
> Wschową	Wschowa	subst:sg:inst:f	nazwa geograficzna	
> Wschowę	Wschowa	subst:sg:acc:f	nazwa geograficzna	
> Wschowie	Wschowa	subst:sg:dat.loc:f	nazwa geograficzna	
> Wschowom	Wschowa	subst:pl:dat:f	nazwa geograficzna	
> Wschowo	Wschowa	subst:sg:voc:f	nazwa geograficzna	
> Wschowy	Wschowa	subst:pl:nom.acc.voc:f	nazwa geograficzna	
> Wschowy	Wschowa	subst:sg:gen:f	nazwa geograficzna	
> Wschów	Wschowa	subst:pl:gen:f	nazwa geograficzna	
> wschowianach	wschowianin	subst:pl:loc:m1	nazwa pospolita	
> wschowianami	wschowianin	subst:pl:inst:m1	nazwa pospolita	
> wschowianie	wschowianin	subst:pl:nom.voc:m1	nazwa pospolita	
> wschowianina	wschowianin	subst:sg:gen.acc:m1	nazwa pospolita	
> wschowianinem	wschowianin	subst:sg:inst:m1	nazwa pospolita	
> wschowianinie	wschowianin	subst:sg:loc:m1	nazwa pospolita	
> wschowianinie	wschowianin	subst:sg:voc:m1	nazwa pospolita	
> wschowianinowi	wschowianin	subst:sg:dat:m1	nazwa pospolita	
> wschowianin	wschowianin	subst:sg:nom:m1	nazwa pospolita	
> wschowianom	wschowianin	subst:pl:dat:m1	nazwa pospolita	
> wschowian	wschowianin	subst:pl:gen.acc:m1	nazwa pospolita	
> wschowiany	wschowianin	depr:pl:nom.acc.voc:m2	nazwa pospolita	
> wschowiance	wschowianka	subst:sg:dat.loc:f	nazwa pospolita	
> wschowianek	wschowianka	subst:pl:gen:f	nazwa pospolita	
> wschowiankach	wschowianka	subst:pl:loc:f	nazwa pospolita	
> wschowiankami	wschowianka	subst:pl:inst:f	nazwa pospolita	
> wschowianka	wschowianka	subst:sg:nom:f	nazwa pospolita	
> wschowianką	wschowianka	subst:sg:inst:f	nazwa pospolita	
> wschowiankę	wschowianka	subst:sg:acc:f	nazwa pospolita	
> wschowianki	wschowianka	subst:pl:nom.acc.voc:f	nazwa pospolita	
> wschowianki	wschowianka	subst:sg:gen:f	nazwa pospolita	
> wschowiankom	wschowianka	subst:pl:dat:f	nazwa pospolita	
> wschowianko	wschowianka	subst:sg:voc:f	nazwa pospolita	
6907300a6908771,6908780
> Zawierciach	Zawiercie	subst:pl:loc:n:ncol	nazwa geograficzna	
> Zawierciami	Zawiercie	subst:pl:inst:n:ncol	nazwa geograficzna	
> Zawiercia	Zawiercie	subst:pl:nom.acc.voc:n:ncol	nazwa geograficzna	
> Zawiercia	Zawiercie	subst:sg:gen:n:ncol	nazwa geograficzna	
> Zawierciem	Zawiercie	subst:sg:inst:n:ncol	nazwa geograficzna	
> Zawiercie	Zawiercie	subst:sg:nom.acc.voc:n:ncol	nazwa geograficzna	
> Zawierciom	Zawiercie	subst:pl:dat:n:ncol	nazwa geograficzna	
> Zawierciu	Zawiercie	subst:sg:dat:n:ncol	nazwa geograficzna	
> Zawierciu	Zawiercie	subst:sg:loc:n:ncol	nazwa geograficzna	
> Zawierć	Zawiercie	subst:pl:gen:n:ncol	nazwa geograficzna	
6927012a6928493,6928515
> ząbkowiczanach	ząbkowiczanin	subst:pl:loc:m1	nazwa pospolita	
> ząbkowiczanami	ząbkowiczanin	subst:pl:inst:m1	nazwa pospolita	
> ząbkowiczanie	ząbkowiczanin	subst:pl:nom.voc:m1	nazwa pospolita	
> ząbkowiczanina	ząbkowiczanin	subst:sg:gen.acc:m1	nazwa pospolita	
> ząbkowiczaninem	ząbkowiczanin	subst:sg:inst:m1	nazwa pospolita	
> ząbkowiczaninie	ząbkowiczanin	subst:sg:loc:m1	nazwa pospolita	
> ząbkowiczaninie	ząbkowiczanin	subst:sg:voc:m1	nazwa pospolita	
> ząbkowiczaninowi	ząbkowiczanin	subst:sg:dat:m1	nazwa pospolita	
> ząbkowiczanin	ząbkowiczanin	subst:sg:nom:m1	nazwa pospolita	
> ząbkowiczanom	ząbkowiczanin	subst:pl:dat:m1	nazwa pospolita	
> ząbkowiczany	ząbkowiczanin	depr:pl:nom.acc.voc:m2	nazwa pospolita	
> ząbkowiczan	ząbkowiczanin	subst:pl:gen.acc:m1	nazwa pospolita	
> ząbkowiczance	ząbkowiczanka	subst:sg:dat.loc:f	nazwa pospolita	
> ząbkowiczanek	ząbkowiczanka	subst:pl:gen:f	nazwa pospolita	
> ząbkowiczankach	ząbkowiczanka	subst:pl:loc:f	nazwa pospolita	
> ząbkowiczankami	ząbkowiczanka	subst:pl:inst:f	nazwa pospolita	
> ząbkowiczanka	ząbkowiczanka	subst:sg:nom:f	nazwa pospolita	
> ząbkowiczanką	ząbkowiczanka	subst:sg:inst:f	nazwa pospolita	
> ząbkowiczankę	ząbkowiczanka	subst:sg:acc:f	nazwa pospolita	
> ząbkowiczanki	ząbkowiczanka	subst:pl:nom.acc.voc:f	nazwa pospolita	
> ząbkowiczanki	ząbkowiczanka	subst:sg:gen:f	nazwa pospolita	
> ząbkowiczankom	ząbkowiczanka	subst:pl:dat:f	nazwa pospolita	
> ząbkowiczanko	ząbkowiczanka	subst:sg:voc:f	nazwa pospolita	
7206779a7208283,7208293
> Żninach	Żnin	subst:pl:loc:m3	nazwa geograficzna	
> Żninami	Żnin	subst:pl:inst:m3	nazwa geograficzna	
> Żnina	Żnin	subst:sg:gen:m3	nazwa geograficzna	
> Żninem	Żnin	subst:sg:inst:m3	nazwa geograficzna	
> Żninie	Żnin	subst:sg:loc:m3	nazwa geograficzna	
> Żninie	Żnin	subst:sg:voc:m3	nazwa geograficzna	
> Żninom	Żnin	subst:pl:dat:m3	nazwa geograficzna	
> Żninowi	Żnin	subst:sg:dat:m3	nazwa geograficzna	
> Żninów	Żnin	subst:pl:gen:m3	nazwa geograficzna	
> Żniny	Żnin	subst:pl:nom.acc.voc:m3	nazwa geograficzna	
> Żnin	Żnin	subst:sg:nom.acc:m3	nazwa geograficzna	
7215703a7217218,7217251
> Żurominach	Żuromin	subst:pl:loc:m3	nazwa geograficzna	
> Żurominami	Żuromin	subst:pl:inst:m3	nazwa geograficzna	
> Żuromina	Żuromin	subst:sg:gen:m3	nazwa geograficzna	
> Żurominem	Żuromin	subst:sg:inst:m3	nazwa geograficzna	
> Żurominie	Żuromin	subst:sg:loc:m3	nazwa geograficzna	
> Żurominie	Żuromin	subst:sg:voc:m3	nazwa geograficzna	
> Żurominom	Żuromin	subst:pl:dat:m3	nazwa geograficzna	
> Żurominowi	Żuromin	subst:sg:dat:m3	nazwa geograficzna	
> Żurominów	Żuromin	subst:pl:gen:m3	nazwa geograficzna	
> Żurominy	Żuromin	subst:pl:nom.acc.voc:m3	nazwa geograficzna	
> Żuromin	Żuromin	subst:sg:nom.acc:m3	nazwa geograficzna	
> żurominianach	żurominianin	subst:pl:loc:m1	nazwa pospolita	
> żurominianami	żurominianin	subst:pl:inst:m1	nazwa pospolita	
> żurominianie	żurominianin	subst:pl:nom.voc:m1	nazwa pospolita	
> żurominianina	żurominianin	subst:sg:gen.acc:m1	nazwa pospolita	
> żurominianinem	żurominianin	subst:sg:inst:m1	nazwa pospolita	
> żurominianinie	żurominianin	subst:sg:loc:m1	nazwa pospolita	
> żurominianinie	żurominianin	subst:sg:voc:m1	nazwa pospolita	
> żurominianinowi	żurominianin	subst:sg:dat:m1	nazwa pospolita	
> żurominianin	żurominianin	subst:sg:nom:m1	nazwa pospolita	
> żurominianom	żurominianin	subst:pl:dat:m1	nazwa pospolita	
> żurominiany	żurominianin	depr:pl:nom.acc.voc:m2	nazwa pospolita	
> żurominian	żurominianin	subst:pl:gen.acc:m1	nazwa pospolita	
> żurominiance	żurominianka	subst:sg:dat.loc:f	nazwa pospolita	
> żurominianek	żurominianka	subst:pl:gen:f	nazwa pospolita	
> żurominiankach	żurominianka	subst:pl:loc:f	nazwa pospolita	
> żurominiankami	żurominianka	subst:pl:inst:f	nazwa pospolita	
> żurominianka	żurominianka	subst:sg:nom:f	nazwa pospolita	
> żurominianką	żurominianka	subst:sg:inst:f	nazwa pospolita	
> żurominiankę	żurominianka	subst:sg:acc:f	nazwa pospolita	
> żurominianki	żurominianka	subst:pl:nom.acc.voc:f	nazwa pospolita	
> żurominianki	żurominianka	subst:sg:gen:f	nazwa pospolita	
> żurominiankom	żurominianka	subst:pl:dat:f	nazwa pospolita	
> żurominianko	żurominianka	subst:sg:voc:f	nazwa pospolita	
